Year,Location,Age,Total,Male,Female
2017,Благоевград,Общо,307882,150007,157875
2017,Благоевград,0,2710,1386,1324
2017,Благоевград,1 - 4,11490,5834,5656
2017,Благоевград,5 - 9,15559,7959,7600
2017,Благоевград,10 - 14,15054,7710,7344
2017,Благоевград,15 - 19,13832,7166,6666
2017,Благоевград,20 - 24,13032,6729,6303
2017,Благоевград,25 - 29,21518,10569,10949
2017,Благоевград,30 - 34,21934,11267,10667
2017,Благоевград,35 - 39,21740,11288,10452
2017,Благоевград,40 - 44,22761,11675,11086
2017,Благоевград,45 - 49,22915,11501,11414
2017,Благоевград,50 - 54,22643,11209,11434
2017,Благоевград,55 - 59,23082,11246,11836
2017,Благоевград,60 - 64,21634,10341,11293
2017,Благоевград,65 - 69,19057,8677,10380
2017,Благоевград,70 - 74,14814,6322,8492
2017,Благоевград,75 - 79,11293,4454,6839
2017,Благоевград,80 - 84,8069,2984,5085
2017,Благоевград,85 - 89,3623,1331,2292
2017,Благоевград,90 - 94,977,320,657
2017,Благоевград,95 - 99,133,37,96
2017,Благоевград,100+,12,2,10
2017,Бургас,Общо,411579,199519,212060
2017,Бургас,0,3922,2006,1916
2017,Бургас,1 - 4,16394,8294,8100
2017,Бургас,5 - 9,22352,11420,10932
2017,Бургас,10 - 14,21305,10994,10311
2017,Бургас,15 - 19,18881,9612,9269
2017,Бургас,20 - 24,17783,9017,8766
2017,Бургас,25 - 29,24302,12296,12006
2017,Бургас,30 - 34,28704,14615,14089
2017,Бургас,35 - 39,31006,16048,14958
2017,Бургас,40 - 44,34415,17672,16743
2017,Бургас,45 - 49,30913,15768,15145
2017,Бургас,50 - 54,26469,13122,13347
2017,Бургас,55 - 59,28193,13555,14638
2017,Бургас,60 - 64,28492,13202,15290
2017,Бургас,65 - 69,27463,12162,15301
2017,Бургас,70 - 74,19902,8346,11556
2017,Бургас,75 - 79,14226,5440,8786
2017,Бургас,80 - 84,10306,3687,6619
2017,Бургас,85 - 89,4956,1766,3190
2017,Бургас,90 - 94,1428,443,985
2017,Бургас,95 - 99,158,51,107
2017,Бургас,100+,9,3,6
2017,Варна,Общо,472120,230301,241819
2017,Варна,0,4437,2341,2096
2017,Варна,1 - 4,18389,9470,8919
2017,Варна,5 - 9,25374,13077,12297
2017,Варна,10 - 14,23301,11983,11318
2017,Варна,15 - 19,21275,10896,10379
2017,Варна,20 - 24,22036,11632,10404
2017,Варна,25 - 29,31989,16327,15662
2017,Варна,30 - 34,35757,17953,17804
2017,Варна,35 - 39,37049,19007,18042
2017,Варна,40 - 44,41018,21072,19946
2017,Варна,45 - 49,35384,18254,17130
2017,Варна,50 - 54,29060,14529,14531
2017,Варна,55 - 59,29286,14267,15019
2017,Варна,60 - 64,30133,13884,16249
2017,Варна,65 - 69,29092,12806,16286
2017,Варна,70 - 74,23504,9862,13642
2017,Варна,75 - 79,15929,6362,9567
2017,Варна,80 - 84,11388,3973,7415
2017,Варна,85 - 89,5884,2035,3849
2017,Варна,90 - 94,1596,497,1099
2017,Варна,95 - 99,227,71,156
2017,Варна,100+,12,3,9
2017,Велико Търново,Общо,239132,115655,123477
2017,Велико Търново,0,1990,1002,988
2017,Велико Търново,1 - 4,8109,4194,3915
2017,Велико Търново,5 - 9,10411,5334,5077
2017,Велико Търново,10 - 14,9888,5103,4785
2017,Велико Търново,15 - 19,10234,5185,5049
2017,Велико Търново,20 - 24,11624,5907,5717
2017,Велико Търново,25 - 29,19343,9743,9600
2017,Велико Търново,30 - 34,15082,7916,7166
2017,Велико Търново,35 - 39,14937,7712,7225
2017,Велико Търново,40 - 44,17016,8796,8220
2017,Велико Търново,45 - 49,16245,8296,7949
2017,Велико Търново,50 - 54,14998,7564,7434
2017,Велико Търново,55 - 59,16314,7996,8318
2017,Велико Търново,60 - 64,17641,8384,9257
2017,Велико Търново,65 - 69,17602,7908,9694
2017,Велико Търново,70 - 74,15283,6435,8848
2017,Велико Търново,75 - 79,10369,3998,6371
2017,Велико Търново,80 - 84,7162,2542,4620
2017,Велико Търново,85 - 89,3784,1300,2484
2017,Велико Търново,90 - 94,954,296,658
2017,Велико Търново,95 - 99,143,41,102
2017,Велико Търново,100+,3,3,-
2017,Видин,Общо,86927,42411,44516
2017,Видин,0,573,291,282
2017,Видин,1 - 4,2367,1216,1151
2017,Видин,5 - 9,3603,1858,1745
2017,Видин,10 - 14,3875,2025,1850
2017,Видин,15 - 19,3751,1887,1864
2017,Видин,20 - 24,3134,1628,1506
2017,Видин,25 - 29,3693,2016,1677
2017,Видин,30 - 34,4333,2313,2020
2017,Видин,35 - 39,4866,2566,2300
2017,Видин,40 - 44,6256,3292,2964
2017,Видин,45 - 49,6849,3635,3214
2017,Видин,50 - 54,5689,3024,2665
2017,Видин,55 - 59,5959,3121,2838
2017,Видин,60 - 64,6520,3151,3369
2017,Видин,65 - 69,7902,3471,4431
2017,Видин,70 - 74,7129,3062,4067
2017,Видин,75 - 79,4559,1796,2763
2017,Видин,80 - 84,3446,1239,2207
2017,Видин,85 - 89,1814,641,1173
2017,Видин,90 - 94,544,161,383
2017,Видин,95 - 99,65,18,47
2017,Видин,100+,-,-,-
2017,Враца,Общо,165645,81459,84186
2017,Враца,0,1324,684,640
2017,Враца,1 - 4,5671,2959,2712
2017,Враца,5 - 9,7654,3960,3694
2017,Враца,10 - 14,7723,3930,3793
2017,Враца,15 - 19,7959,4080,3879
2017,Враца,20 - 24,6970,3654,3316
2017,Враца,25 - 29,8313,4463,3850
2017,Враца,30 - 34,9065,4829,4236
2017,Враца,35 - 39,10022,5231,4791
2017,Враца,40 - 44,11980,6200,5780
2017,Враца,45 - 49,13217,7010,6207
2017,Враца,50 - 54,11704,6117,5587
2017,Враца,55 - 59,12209,6314,5895
2017,Враца,60 - 64,12274,5877,6397
2017,Враца,65 - 69,12485,5666,6819
2017,Враца,70 - 74,11003,4582,6421
2017,Враца,75 - 79,7096,2790,4306
2017,Враца,80 - 84,5236,1886,3350
2017,Враца,85 - 89,2849,982,1867
2017,Враца,90 - 94,777,220,557
2017,Враца,95 - 99,108,23,85
2017,Враца,100+,6,2,4
2017,Габрово,Общо,110254,53243,57011
2017,Габрово,0,730,386,344
2017,Габрово,1 - 4,3072,1607,1465
2017,Габрово,5 - 9,4452,2278,2174
2017,Габрово,10 - 14,4378,2238,2140
2017,Габрово,15 - 19,4190,2150,2040
2017,Габрово,20 - 24,3851,2100,1751
2017,Габрово,25 - 29,5466,3092,2374
2017,Габрово,30 - 34,5878,3196,2682
2017,Габрово,35 - 39,6698,3552,3146
2017,Габрово,40 - 44,8270,4305,3965
2017,Габрово,45 - 49,8115,4194,3921
2017,Габрово,50 - 54,7611,3812,3799
2017,Габрово,55 - 59,7958,3895,4063
2017,Габрово,60 - 64,8444,3993,4451
2017,Габрово,65 - 69,9461,4069,5392
2017,Габрово,70 - 74,8439,3499,4940
2017,Габрово,75 - 79,5980,2322,3658
2017,Габрово,80 - 84,4364,1580,2784
2017,Габрово,85 - 89,2150,760,1390
2017,Габрово,90 - 94,644,183,461
2017,Габрово,95 - 99,102,32,70
2017,Габрово,100+,1,-,1
2017,Добрич,Общо,176145,85739,90406
2017,Добрич,0,1402,715,687
2017,Добрич,1 - 4,6043,3090,2953
2017,Добрич,5 - 9,8738,4546,4192
2017,Добрич,10 - 14,8791,4507,4284
2017,Добрич,15 - 19,8265,4238,4027
2017,Добрич,20 - 24,7854,4012,3842
2017,Добрич,25 - 29,9787,5183,4604
2017,Добрич,30 - 34,10869,5723,5146
2017,Добрич,35 - 39,11257,5871,5386
2017,Добрич,40 - 44,13521,6942,6579
2017,Добрич,45 - 49,13807,7020,6787
2017,Добрич,50 - 54,12294,6279,6015
2017,Добрич,55 - 59,12821,6181,6640
2017,Добрич,60 - 64,12811,5971,6840
2017,Добрич,65 - 69,13140,5791,7349
2017,Добрич,70 - 74,10286,4223,6063
2017,Добрич,75 - 79,7112,2756,4356
2017,Добрич,80 - 84,4433,1649,2784
2017,Добрич,85 - 89,2222,824,1398
2017,Добрич,90 - 94,602,198,404
2017,Добрич,95 - 99,89,20,69
2017,Добрич,100+,1,-,1
2017,Кърджали,Общо,151113,74958,76155
2017,Кърджали,0,1417,716,701
2017,Кърджали,1 - 4,5735,3026,2709
2017,Кърджали,5 - 9,7248,3706,3542
2017,Кърджали,10 - 14,7060,3612,3448
2017,Кърджали,15 - 19,6457,3346,3111
2017,Кърджали,20 - 24,6244,3210,3034
2017,Кърджали,25 - 29,8717,4466,4251
2017,Кърджали,30 - 34,9985,4996,4989
2017,Кърджали,35 - 39,11393,5919,5474
2017,Кърджали,40 - 44,11110,5930,5180
2017,Кърджали,45 - 49,11154,5946,5208
2017,Кърджали,50 - 54,11168,5772,5396
2017,Кърджали,55 - 59,11968,5954,6014
2017,Кърджали,60 - 64,11981,5680,6301
2017,Кърджали,65 - 69,9926,4587,5339
2017,Кърджали,70 - 74,6828,2994,3834
2017,Кърджали,75 - 79,6139,2557,3582
2017,Кърджали,80 - 84,4141,1637,2504
2017,Кърджали,85 - 89,1819,694,1125
2017,Кърджали,90 - 94,535,198,337
2017,Кърджали,95 - 99,76,11,65
2017,Кърджали,100+,12,1,11
2017,Кюстендил,Общо,121099,58819,62280
2017,Кюстендил,0,870,453,417
2017,Кюстендил,1 - 4,3584,1807,1777
2017,Кюстендил,5 - 9,4942,2545,2397
2017,Кюстендил,10 - 14,5136,2663,2473
2017,Кюстендил,15 - 19,4796,2497,2299
2017,Кюстендил,20 - 24,3772,2065,1707
2017,Кюстендил,25 - 29,5170,2784,2386
2017,Кюстендил,30 - 34,6535,3522,3013
2017,Кюстендил,35 - 39,7639,4069,3570
2017,Кюстендил,40 - 44,8928,4623,4305
2017,Кюстендил,45 - 49,9424,4878,4546
2017,Кюстендил,50 - 54,8870,4554,4316
2017,Кюстендил,55 - 59,9339,4649,4690
2017,Кюстендил,60 - 64,9572,4486,5086
2017,Кюстендил,65 - 69,9861,4431,5430
2017,Кюстендил,70 - 74,8638,3619,5019
2017,Кюстендил,75 - 79,6226,2419,3807
2017,Кюстендил,80 - 84,4596,1688,2908
2017,Кюстендил,85 - 89,2411,842,1569
2017,Кюстендил,90 - 94,675,186,489
2017,Кюстендил,95 - 99,112,38,74
2017,Кюстендил,100+,3,1,2
2017,Ловеч,Общо,126961,61906,65055
2017,Ловеч,0,1017,532,485
2017,Ловеч,1 - 4,4064,2066,1998
2017,Ловеч,5 - 9,5871,2975,2896
2017,Ловеч,10 - 14,5929,3047,2882
2017,Ловеч,15 - 19,5870,3023,2847
2017,Ловеч,20 - 24,4793,2530,2263
2017,Ловеч,25 - 29,6019,3226,2793
2017,Ловеч,30 - 34,6558,3468,3090
2017,Ловеч,35 - 39,7282,3866,3416
2017,Ловеч,40 - 44,8952,4694,4258
2017,Ловеч,45 - 49,9569,5038,4531
2017,Ловеч,50 - 54,8795,4501,4294
2017,Ловеч,55 - 59,9130,4666,4464
2017,Ловеч,60 - 64,9279,4445,4834
2017,Ловеч,65 - 69,10050,4432,5618
2017,Ловеч,70 - 74,9016,3745,5271
2017,Ловеч,75 - 79,6489,2537,3952
2017,Ловеч,80 - 84,4982,1937,3045
2017,Ловеч,85 - 89,2475,896,1579
2017,Ловеч,90 - 94,708,235,473
2017,Ловеч,95 - 99,111,47,64
2017,Ловеч,100+,2,-,2
2017,Монтана,Общо,132214,64678,67536
2017,Монтана,0,1024,511,513
2017,Монтана,1 - 4,4546,2390,2156
2017,Монтана,5 - 9,6168,3167,3001
2017,Монтана,10 - 14,6054,3116,2938
2017,Монтана,15 - 19,6372,3272,3100
2017,Монтана,20 - 24,5429,2850,2579
2017,Монтана,25 - 29,6504,3436,3068
2017,Монтана,30 - 34,7098,3787,3311
2017,Монтана,35 - 39,7657,4101,3556
2017,Монтана,40 - 44,9140,4725,4415
2017,Монтана,45 - 49,9701,5066,4635
2017,Монтана,50 - 54,8853,4623,4230
2017,Монтана,55 - 59,9416,4802,4614
2017,Монтана,60 - 64,9826,4812,5014
2017,Монтана,65 - 69,10707,4880,5827
2017,Монтана,70 - 74,9176,3804,5372
2017,Монтана,75 - 79,6378,2392,3986
2017,Монтана,80 - 84,4837,1777,3060
2017,Монтана,85 - 89,2483,887,1596
2017,Монтана,90 - 94,738,245,493
2017,Монтана,95 - 99,105,33,72
2017,Монтана,100+,2,2,-
2017,Пазарджик,Общо,257965,126454,131511
2017,Пазарджик,0,2347,1208,1139
2017,Пазарджик,1 - 4,9915,5077,4838
2017,Пазарджик,5 - 9,13434,6954,6480
2017,Пазарджик,10 - 14,13032,6726,6306
2017,Пазарджик,15 - 19,12659,6607,6052
2017,Пазарджик,20 - 24,11164,5853,5311
2017,Пазарджик,25 - 29,14863,7724,7139
2017,Пазарджик,30 - 34,16797,8877,7920
2017,Пазарджик,35 - 39,17285,9227,8058
2017,Пазарджик,40 - 44,18257,9580,8677
2017,Пазарджик,45 - 49,19316,9835,9481
2017,Пазарджик,50 - 54,18421,9334,9087
2017,Пазарджик,55 - 59,19983,9988,9995
2017,Пазарджик,60 - 64,18360,8712,9648
2017,Пазарджик,65 - 69,16691,7373,9318
2017,Пазарджик,70 - 74,13708,5592,8116
2017,Пазарджик,75 - 79,10128,3786,6342
2017,Пазарджик,80 - 84,7187,2597,4590
2017,Пазарджик,85 - 89,3341,1100,2241
2017,Пазарджик,90 - 94,959,270,689
2017,Пазарджик,95 - 99,113,33,80
2017,Пазарджик,100+,5,1,4
2017,Перник,Общо,122421,59646,62775
2017,Перник,0,943,473,470
2017,Перник,1 - 4,3765,1966,1799
2017,Перник,5 - 9,5290,2777,2513
2017,Перник,10 - 14,4920,2552,2368
2017,Перник,15 - 19,4705,2452,2253
2017,Перник,20 - 24,4098,2202,1896
2017,Перник,25 - 29,5510,2969,2541
2017,Перник,30 - 34,7497,3935,3562
2017,Перник,35 - 39,8748,4675,4073
2017,Перник,40 - 44,9569,4936,4633
2017,Перник,45 - 49,9158,4754,4404
2017,Перник,50 - 54,8676,4393,4283
2017,Перник,55 - 59,9601,4700,4901
2017,Перник,60 - 64,9463,4490,4973
2017,Перник,65 - 69,9266,4126,5140
2017,Перник,70 - 74,7792,3231,4561
2017,Перник,75 - 79,5813,2252,3561
2017,Перник,80 - 84,4585,1665,2920
2017,Перник,85 - 89,2300,834,1466
2017,Перник,90 - 94,628,235,393
2017,Перник,95 - 99,91,28,63
2017,Перник,100+,3,1,2
2017,Плевен,Общо,244209,119044,125165
2017,Плевен,0,2123,1095,1028
2017,Плевен,1 - 4,8754,4539,4215
2017,Плевен,5 - 9,11485,5857,5628
2017,Плевен,10 - 14,11403,5844,5559
2017,Плевен,15 - 19,11004,5619,5385
2017,Плевен,20 - 24,10109,5129,4980
2017,Плевен,25 - 29,12364,6570,5794
2017,Плевен,30 - 34,13668,7168,6500
2017,Плевен,35 - 39,14272,7559,6713
2017,Плевен,40 - 44,16718,8664,8054
2017,Плевен,45 - 49,17737,9270,8467
2017,Плевен,50 - 54,16037,8210,7827
2017,Плевен,55 - 59,17503,8808,8695
2017,Плевен,60 - 64,18343,8898,9445
2017,Плевен,65 - 69,19401,8898,10503
2017,Плевен,70 - 74,17033,7263,9770
2017,Плевен,75 - 79,11655,4424,7231
2017,Плевен,80 - 84,8718,3242,5476
2017,Плевен,85 - 89,4379,1487,2892
2017,Плевен,90 - 94,1336,450,886
2017,Плевен,95 - 99,156,46,110
2017,Плевен,100+,11,4,7
2017,Пловдив,Общо,669796,322158,347638
2017,Пловдив,0,6386,3237,3149
2017,Пловдив,1 - 4,26319,13539,12780
2017,Пловдив,5 - 9,33798,17559,16239
2017,Пловдив,10 - 14,30837,15817,15020
2017,Пловдив,15 - 19,29643,15289,14354
2017,Пловдив,20 - 24,32100,16459,15641
2017,Пловдив,25 - 29,43038,21563,21475
2017,Пловдив,30 - 34,47065,24003,23062
2017,Пловдив,35 - 39,48922,25270,23652
2017,Пловдив,40 - 44,51430,26251,25179
2017,Пловдив,45 - 49,48544,24599,23945
2017,Пловдив,50 - 54,43379,21293,22086
2017,Пловдив,55 - 59,45830,22137,23693
2017,Пловдив,60 - 64,44192,20675,23517
2017,Пловдив,65 - 69,42444,18377,24067
2017,Пловдив,70 - 74,35300,14426,20874
2017,Пловдив,75 - 79,26738,10111,16627
2017,Пловдив,80 - 84,20221,7045,13176
2017,Пловдив,85 - 89,10202,3453,6749
2017,Пловдив,90 - 94,2974,926,2048
2017,Пловдив,95 - 99,414,125,289
2017,Пловдив,100+,20,4,16
2017,Разград,Общо,113714,55437,58277
2017,Разград,0,889,449,440
2017,Разград,1 - 4,3924,1996,1928
2017,Разград,5 - 9,5415,2797,2618
2017,Разград,10 - 14,5369,2759,2610
2017,Разград,15 - 19,5535,2855,2680
2017,Разград,20 - 24,5278,2737,2541
2017,Разград,25 - 29,6203,3166,3037
2017,Разград,30 - 34,6685,3495,3190
2017,Разград,35 - 39,7346,3788,3558
2017,Разград,40 - 44,8484,4395,4089
2017,Разград,45 - 49,9116,4728,4388
2017,Разград,50 - 54,8500,4416,4084
2017,Разград,55 - 59,8434,4125,4309
2017,Разград,60 - 64,8500,4035,4465
2017,Разград,65 - 69,8241,3699,4542
2017,Разград,70 - 74,6752,2663,4089
2017,Разград,75 - 79,4568,1739,2829
2017,Разград,80 - 84,2875,1084,1791
2017,Разград,85 - 89,1228,391,837
2017,Разград,90 - 94,328,112,216
2017,Разград,95 - 99,39,8,31
2017,Разград,100+,5,-,5
2017,Русе,Общо,221336,108150,113186
2017,Русе,0,1699,929,770
2017,Русе,1 - 4,7263,3810,3453
2017,Русе,5 - 9,9702,5022,4680
2017,Русе,10 - 14,9323,4767,4556
2017,Русе,15 - 19,9180,4755,4425
2017,Русе,20 - 24,11046,5900,5146
2017,Русе,25 - 29,13937,7642,6295
2017,Русе,30 - 34,14222,7481,6741
2017,Русе,35 - 39,14303,7581,6722
2017,Русе,40 - 44,16771,8552,8219
2017,Русе,45 - 49,16314,8333,7981
2017,Русе,50 - 54,14956,7517,7439
2017,Русе,55 - 59,15375,7635,7740
2017,Русе,60 - 64,16358,7794,8564
2017,Русе,65 - 69,15963,7032,8931
2017,Русе,70 - 74,14196,5748,8448
2017,Русе,75 - 79,9601,3717,5884
2017,Русе,80 - 84,6732,2427,4305
2017,Русе,85 - 89,3380,1157,2223
2017,Русе,90 - 94,896,307,589
2017,Русе,95 - 99,115,44,71
2017,Русе,100+,4,-,4
2017,Силистра,Общо,110562,54199,56363
2017,Силистра,0,925,473,452
2017,Силистра,1 - 4,3894,1986,1908
2017,Силистра,5 - 9,5204,2685,2519
2017,Силистра,10 - 14,5146,2714,2432
2017,Силистра,15 - 19,5007,2589,2418
2017,Силистра,20 - 24,4615,2331,2284
2017,Силистра,25 - 29,5912,3121,2791
2017,Силистра,30 - 34,6424,3441,2983
2017,Силистра,35 - 39,6522,3435,3087
2017,Силистра,40 - 44,7740,3976,3764
2017,Силистра,45 - 49,8494,4426,4068
2017,Силистра,50 - 54,8115,4148,3967
2017,Силистра,55 - 59,8100,4061,4039
2017,Силистра,60 - 64,8294,3896,4398
2017,Силистра,65 - 69,8725,3903,4822
2017,Силистра,70 - 74,7362,3158,4204
2017,Силистра,75 - 79,5317,2118,3199
2017,Силистра,80 - 84,3053,1150,1903
2017,Силистра,85 - 89,1309,475,834
2017,Силистра,90 - 94,350,101,249
2017,Силистра,95 - 99,49,11,38
2017,Силистра,100+,5,1,4
2017,Сливен,Общо,188433,91614,96819
2017,Сливен,0,2361,1203,1158
2017,Сливен,1 - 4,9388,4829,4559
2017,Сливен,5 - 9,11532,5909,5623
2017,Сливен,10 - 14,11439,5725,5714
2017,Сливен,15 - 19,10601,5441,5160
2017,Сливен,20 - 24,9007,4686,4321
2017,Сливен,25 - 29,10756,5614,5142
2017,Сливен,30 - 34,11474,6060,5414
2017,Сливен,35 - 39,12237,6367,5870
2017,Сливен,40 - 44,13432,6750,6682
2017,Сливен,45 - 49,12402,6251,6151
2017,Сливен,50 - 54,11830,5943,5887
2017,Сливен,55 - 59,12718,6326,6392
2017,Сливен,60 - 64,12644,5942,6702
2017,Сливен,65 - 69,12234,5322,6912
2017,Сливен,70 - 74,9486,3896,5590
2017,Сливен,75 - 79,6822,2512,4310
2017,Сливен,80 - 84,5063,1812,3251
2017,Сливен,85 - 89,2314,822,1492
2017,Сливен,90 - 94,626,185,441
2017,Сливен,95 - 99,63,17,46
2017,Сливен,100+,4,2,2
2017,Смолян,Общо,107282,51960,55322
2017,Смолян,0,742,352,390
2017,Смолян,1 - 4,2949,1466,1483
2017,Смолян,5 - 9,4269,2178,2091
2017,Смолян,10 - 14,4389,2303,2086
2017,Смолян,15 - 19,4203,2172,2031
2017,Смолян,20 - 24,3378,1778,1600
2017,Смолян,25 - 29,5156,2837,2319
2017,Смолян,30 - 34,6635,3581,3054
2017,Смолян,35 - 39,7313,3916,3397
2017,Смолян,40 - 44,7581,3927,3654
2017,Смолян,45 - 49,8096,4124,3972
2017,Смолян,50 - 54,8617,4298,4319
2017,Смолян,55 - 59,9762,4841,4921
2017,Смолян,60 - 64,9553,4405,5148
2017,Смолян,65 - 69,8509,3713,4796
2017,Смолян,70 - 74,6288,2498,3790
2017,Смолян,75 - 79,4740,1856,2884
2017,Смолян,80 - 84,3115,1118,1997
2017,Смолян,85 - 89,1486,462,1024
2017,Смолян,90 - 94,427,117,310
2017,Смолян,95 - 99,69,16,53
2017,Смолян,100+,5,2,3
2017,София,Общо,231563,113849,117714
2017,София,0,1982,1004,978
2017,София,1 - 4,7969,4072,3897
2017,София,5 - 9,10823,5517,5306
2017,София,10 - 14,10752,5616,5136
2017,София,15 - 19,10493,5465,5028
2017,София,20 - 24,9651,4959,4692
2017,София,25 - 29,11845,6368,5477
2017,София,30 - 34,14143,7590,6553
2017,София,35 - 39,15388,8204,7184
2017,София,40 - 44,17469,9111,8358
2017,София,45 - 49,17796,9179,8617
2017,София,50 - 54,16374,8481,7893
2017,София,55 - 59,16632,8404,8228
2017,София,60 - 64,16535,7935,8600
2017,София,65 - 69,16810,7539,9271
2017,София,70 - 74,14188,6053,8135
2017,София,75 - 79,9983,3877,6106
2017,София,80 - 84,7603,2696,4907
2017,София,85 - 89,3935,1396,2539
2017,София,90 - 94,1043,337,706
2017,София,95 - 99,138,42,96
2017,София,100+,11,4,7
2017,София (столица),Общо,1325429,635040,690389
2017,София (столица),0,13387,6893,6494
2017,София (столица),1 - 4,54043,27645,26398
2017,София (столица),5 - 9,67825,34848,32977
2017,София (столица),10 - 14,55556,28591,26965
2017,София (столица),15 - 19,53766,27622,26144
2017,София (столица),20 - 24,76710,39067,37643
2017,София (столица),25 - 29,111884,56765,55119
2017,София (столица),30 - 34,113846,57498,56348
2017,София (столица),35 - 39,111322,55939,55383
2017,София (столица),40 - 44,116230,58595,57635
2017,София (столица),45 - 49,94819,47675,47144
2017,София (столица),50 - 54,75250,36958,38292
2017,София (столица),55 - 59,74916,34800,40116
2017,София (столица),60 - 64,77270,33795,43475
2017,София (столица),65 - 69,76288,31562,44726
2017,София (столица),70 - 74,58754,23637,35117
2017,София (столица),75 - 79,39207,14914,24293
2017,София (столица),80 - 84,29930,10309,19621
2017,София (столица),85 - 89,17209,5652,11557
2017,София (столица),90 - 94,6187,1954,4233
2017,София (столица),95 - 99,991,308,683
2017,София (столица),100+,39,13,26
2017,Стара Загора,Общо,319067,154706,164361
2017,Стара Загора,0,3075,1615,1460
2017,Стара Загора,1 - 4,12466,6471,5995
2017,Стара Загора,5 - 9,16374,8383,7991
2017,Стара Загора,10 - 14,15316,7992,7324
2017,Стара Загора,15 - 19,14811,7636,7175
2017,Стара Загора,20 - 24,13637,6816,6821
2017,Стара Загора,25 - 29,17780,8984,8796
2017,Стара Загора,30 - 34,20324,10604,9720
2017,Стара Загора,35 - 39,21990,11648,10342
2017,Стара Загора,40 - 44,24545,12808,11737
2017,Стара Загора,45 - 49,23021,11881,11140
2017,Стара Загора,50 - 54,20978,10635,10343
2017,Стара Загора,55 - 59,21947,10763,11184
2017,Стара Загора,60 - 64,22592,10536,12056
2017,Стара Загора,65 - 69,22351,9716,12635
2017,Стара Загора,70 - 74,18012,7264,10748
2017,Стара Загора,75 - 79,13261,5126,8135
2017,Стара Загора,80 - 84,10183,3687,6496
2017,Стара Загора,85 - 89,4923,1687,3236
2017,Стара Загора,90 - 94,1290,403,887
2017,Стара Загора,95 - 99,183,49,134
2017,Стара Загора,100+,8,2,6
2017,Търговище,Общо,112474,54942,57532
2017,Търговище,0,947,459,488
2017,Търговище,1 - 4,4212,2117,2095
2017,Търговище,5 - 9,5802,3017,2785
2017,Търговище,10 - 14,5709,2908,2801
2017,Търговище,15 - 19,5450,2772,2678
2017,Търговище,20 - 24,5132,2646,2486
2017,Търговище,25 - 29,6243,3229,3014
2017,Търговище,30 - 34,6653,3466,3187
2017,Търговище,35 - 39,7425,3908,3517
2017,Търговище,40 - 44,8223,4194,4029
2017,Търговище,45 - 49,8504,4481,4023
2017,Търговище,50 - 54,7932,4074,3858
2017,Търговище,55 - 59,8409,4196,4213
2017,Търговище,60 - 64,8058,3901,4157
2017,Търговище,65 - 69,7758,3390,4368
2017,Търговище,70 - 74,6476,2630,3846
2017,Търговище,75 - 79,4634,1809,2825
2017,Търговище,80 - 84,3079,1125,1954
2017,Търговище,85 - 89,1339,477,862
2017,Търговище,90 - 94,420,127,293
2017,Търговище,95 - 99,68,16,52
2017,Търговище,100+,1,-,1
2017,Хасково,Общо,231276,113000,118276
2017,Хасково,0,2060,1047,1013
2017,Хасково,1 - 4,8704,4462,4242
2017,Хасково,5 - 9,11636,5887,5749
2017,Хасково,10 - 14,11150,5717,5433
2017,Хасково,15 - 19,10390,5302,5088
2017,Хасково,20 - 24,9822,5164,4658
2017,Хасково,25 - 29,12023,6374,5649
2017,Хасково,30 - 34,14434,7649,6785
2017,Хасково,35 - 39,16034,8430,7604
2017,Хасково,40 - 44,17405,9101,8304
2017,Хасково,45 - 49,16485,8524,7961
2017,Хасково,50 - 54,15757,7875,7882
2017,Хасково,55 - 59,16759,8309,8450
2017,Хасково,60 - 64,17382,8318,9064
2017,Хасково,65 - 69,16152,7267,8885
2017,Хасково,70 - 74,12546,5230,7316
2017,Хасково,75 - 79,9475,3724,5751
2017,Хасково,80 - 84,7787,2829,4958
2017,Хасково,85 - 89,4026,1403,2623
2017,Хасково,90 - 94,1092,350,742
2017,Хасково,95 - 99,144,36,108
2017,Хасково,100+,13,2,11
2017,Шумен,Общо,172966,84539,88427
2017,Шумен,0,1380,685,695
2017,Шумен,1 - 4,6218,3196,3022
2017,Шумен,5 - 9,8402,4311,4091
2017,Шумен,10 - 14,8365,4386,3979
2017,Шумен,15 - 19,8100,4169,3931
2017,Шумен,20 - 24,8202,4252,3950
2017,Шумен,25 - 29,10716,5521,5195
2017,Шумен,30 - 34,11035,5655,5380
2017,Шумен,35 - 39,11535,5926,5609
2017,Шумен,40 - 44,13240,6784,6456
2017,Шумен,45 - 49,13337,7076,6261
2017,Шумен,50 - 54,11669,5976,5693
2017,Шумен,55 - 59,12424,6200,6224
2017,Шумен,60 - 64,12111,5712,6399
2017,Шумен,65 - 69,12729,5680,7049
2017,Шумен,70 - 74,9533,3924,5609
2017,Шумен,75 - 79,6540,2465,4075
2017,Шумен,80 - 84,4628,1691,2937
2017,Шумен,85 - 89,2125,729,1396
2017,Шумен,90 - 94,578,176,402
2017,Шумен,95 - 99,91,23,68
2017,Шумен,100+,8,2,6
2017,Ямбол,Общо,120470,58976,61494
2017,Ямбол,0,1130,563,567
2017,Ямбол,1 - 4,4712,2386,2326
2017,Ямбол,5 - 9,6060,3097,2963
2017,Ямбол,10 - 14,6002,3081,2921
2017,Ямбол,15 - 19,5603,2889,2714
2017,Ямбол,20 - 24,4727,2515,2212
2017,Ямбол,25 - 29,6186,3227,2959
2017,Ямбол,30 - 34,7067,3785,3282
2017,Ямбол,35 - 39,7466,4002,3464
2017,Ямбол,40 - 44,8436,4351,4085
2017,Ямбол,45 - 49,8111,4131,3980
2017,Ямбол,50 - 54,8140,4106,4034
2017,Ямбол,55 - 59,9021,4525,4496
2017,Ямбол,60 - 64,9286,4529,4757
2017,Ямбол,65 - 69,9330,4269,5061
2017,Ямбол,70 - 74,6819,2835,3984
2017,Ямбол,75 - 79,5439,2140,3299
2017,Ямбол,80 - 84,4367,1652,2715
2017,Ямбол,85 - 89,1954,691,1263
2017,Ямбол,90 - 94,549,176,373
2017,Ямбол,95 - 99,62,23,39
2017,Ямбол,100+,3,3,-
2018,Благоевград,Общо,305123,148542,156581
2018,Благоевград,0,2658,1397,1261
2018,Благоевград,1 - 4,11451,5801,5650
2018,Благоевград,5 - 9,15083,7734,7349
2018,Благоевград,10 - 14,15500,7949,7551
2018,Благоевград,15 - 19,13803,7140,6663
2018,Благоевград,20 - 24,12025,6193,5832
2018,Благоевград,25 - 29,19713,9739,9974
2018,Благоевград,30 - 34,22111,11282,10829
2018,Благоевград,35 - 39,21525,11179,10346
2018,Благоевград,40 - 44,22555,11592,10963
2018,Благоевград,45 - 49,22514,11438,11076
2018,Благоевград,50 - 54,22532,11067,11465
2018,Благоевград,55 - 59,23082,11208,11874
2018,Благоевград,60 - 64,21644,10276,11368
2018,Благоевград,65 - 69,19342,8886,10456
2018,Благоевград,70 - 74,15313,6521,8792
2018,Благоевград,75 - 79,11197,4383,6814
2018,Благоевград,80 - 84,7970,2958,5012
2018,Благоевград,85 - 89,3919,1424,2495
2018,Благоевград,90 - 94,1024,333,691
2018,Благоевград,95 - 99,157,41,116
2018,Благоевград,100+,5,1,4
2018,Бургас,Общо,410331,198630,211701
2018,Бургас,0,3731,1957,1774
2018,Бургас,1 - 4,16381,8326,8055
2018,Бургас,5 - 9,21916,11186,10730
2018,Бургас,10 - 14,22020,11362,10658
2018,Бургас,15 - 19,19208,9730,9478
2018,Бургас,20 - 24,16869,8658,8211
2018,Бургас,25 - 29,22752,11410,11342
2018,Бургас,30 - 34,28314,14299,14015
2018,Бургас,35 - 39,30495,15816,14679
2018,Бургас,40 - 44,33956,17430,16526
2018,Бургас,45 - 49,31420,15982,15438
2018,Бургас,50 - 54,27161,13546,13615
2018,Бургас,55 - 59,27785,13365,14420
2018,Бургас,60 - 64,28193,12993,15200
2018,Бургас,65 - 69,27237,12110,15127
2018,Бургас,70 - 74,21428,8971,12457
2018,Бургас,75 - 79,14362,5514,8848
2018,Бургас,80 - 84,10310,3647,6663
2018,Бургас,85 - 89,5066,1779,3287
2018,Бургас,90 - 94,1528,496,1032
2018,Бургас,95 - 99,190,49,141
2018,Бургас,100+,9,4,5
2018,Варна,Общо,471252,229614,241638
2018,Варна,0,4274,2193,2081
2018,Варна,1 - 4,18428,9534,8894
2018,Варна,5 - 9,24807,12760,12047
2018,Варна,10 - 14,24108,12407,11701
2018,Варна,15 - 19,21605,11094,10511
2018,Варна,20 - 24,21498,11371,10127
2018,Варна,25 - 29,30010,15367,14643
2018,Варна,30 - 34,35545,17834,17711
2018,Варна,35 - 39,36415,18674,17741
2018,Варна,40 - 44,40931,20998,19933
2018,Варна,45 - 49,36018,18439,17579
2018,Варна,50 - 54,29952,15041,14911
2018,Варна,55 - 59,29235,14242,14993
2018,Варна,60 - 64,29434,13670,15764
2018,Варна,65 - 69,28987,12715,16272
2018,Варна,70 - 74,24417,10155,14262
2018,Варна,75 - 79,16428,6525,9903
2018,Варна,80 - 84,11165,3936,7229
2018,Варна,85 - 89,6089,2062,4027
2018,Варна,90 - 94,1669,518,1151
2018,Варна,95 - 99,225,74,151
2018,Варна,100+,12,5,7
2018,Велико Търново,Общо,235708,113916,121792
2018,Велико Търново,0,1830,903,927
2018,Велико Търново,1 - 4,7993,4132,3861
2018,Велико Търново,5 - 9,10287,5256,5031
2018,Велико Търново,10 - 14,9929,5119,4810
2018,Велико Търново,15 - 19,10164,5116,5048
2018,Велико Търново,20 - 24,11045,5527,5518
2018,Велико Търново,25 - 29,17362,8880,8482
2018,Велико Търново,30 - 34,15861,8311,7550
2018,Велико Търново,35 - 39,14548,7495,7053
2018,Велико Търново,40 - 44,16865,8677,8188
2018,Велико Търново,45 - 49,16127,8299,7828
2018,Велико Търново,50 - 54,15007,7543,7464
2018,Велико Търново,55 - 59,16025,7914,8111
2018,Велико Търново,60 - 64,17230,8158,9072
2018,Велико Търново,65 - 69,17126,7692,9434
2018,Велико Търново,70 - 74,15602,6595,9007
2018,Велико Търново,75 - 79,10736,4181,6555
2018,Велико Търново,80 - 84,6909,2429,4480
2018,Велико Търново,85 - 89,3896,1312,2584
2018,Велико Търново,90 - 94,1007,333,674
2018,Велико Търново,95 - 99,157,44,113
2018,Велико Търново,100+,2,-,2
2018,Видин,Общо,84865,41349,43516
2018,Видин,0,593,311,282
2018,Видин,1 - 4,2336,1222,1114
2018,Видин,5 - 9,3523,1797,1726
2018,Видин,10 - 14,3794,1965,1829
2018,Видин,15 - 19,3770,1910,1860
2018,Видин,20 - 24,2749,1407,1342
2018,Видин,25 - 29,3593,1955,1638
2018,Видин,30 - 34,4114,2196,1918
2018,Видин,35 - 39,4607,2433,2174
2018,Видин,40 - 44,6008,3165,2843
2018,Видин,45 - 49,6755,3549,3206
2018,Видин,50 - 54,5781,3091,2690
2018,Видин,55 - 59,5926,3079,2847
2018,Видин,60 - 64,6168,3010,3158
2018,Видин,65 - 69,7420,3275,4145
2018,Видин,70 - 74,7300,3140,4160
2018,Видин,75 - 79,4718,1872,2846
2018,Видин,80 - 84,3350,1192,2158
2018,Видин,85 - 89,1733,585,1148
2018,Видин,90 - 94,563,178,385
2018,Видин,95 - 99,63,17,46
2018,Видин,100+,1,-,1
2018,Враца,Общо,162549,79894,82655
2018,Враца,0,1358,696,662
2018,Враца,1 - 4,5679,2981,2698
2018,Враца,5 - 9,7443,3851,3592
2018,Враца,10 - 14,7715,3929,3786
2018,Враца,15 - 19,7918,4069,3849
2018,Враца,20 - 24,6396,3320,3076
2018,Враца,25 - 29,8023,4276,3747
2018,Враца,30 - 34,8908,4762,4146
2018,Враца,35 - 39,9584,5005,4579
2018,Враца,40 - 44,11468,5966,5502
2018,Враца,45 - 49,12763,6691,6072
2018,Враца,50 - 54,11898,6242,5656
2018,Враца,55 - 59,12069,6251,5818
2018,Враца,60 - 64,12034,5814,6220
2018,Враца,65 - 69,12000,5490,6510
2018,Враца,70 - 74,11185,4657,6528
2018,Враца,75 - 79,7377,2877,4500
2018,Враца,80 - 84,4973,1813,3160
2018,Враца,85 - 89,2864,963,1901
2018,Враца,90 - 94,767,211,556
2018,Враца,95 - 99,122,29,93
2018,Враца,100+,5,1,4
2018,Габрово,Общо,108404,52213,56191
2018,Габрово,0,745,369,376
2018,Габрово,1 - 4,3046,1605,1441
2018,Габрово,5 - 9,4347,2206,2141
2018,Габрово,10 - 14,4456,2291,2165
2018,Габрово,15 - 19,4139,2149,1990
2018,Габрово,20 - 24,3452,1800,1652
2018,Габрово,25 - 29,5164,2918,2246
2018,Габрово,30 - 34,5796,3174,2622
2018,Габрово,35 - 39,6336,3372,2964
2018,Габрово,40 - 44,8103,4207,3896
2018,Габрово,45 - 49,8084,4185,3899
2018,Габрово,50 - 54,7569,3811,3758
2018,Габрово,55 - 59,7966,3895,4071
2018,Габрово,60 - 64,8160,3886,4274
2018,Габрово,65 - 69,9107,3931,5176
2018,Габрово,70 - 74,8647,3544,5103
2018,Габрово,75 - 79,5988,2333,3655
2018,Габрово,80 - 84,4276,1529,2747
2018,Габрово,85 - 89,2295,790,1505
2018,Габрово,90 - 94,614,185,429
2018,Габрово,95 - 99,112,33,79
2018,Габрово,100+,2,-,2
2018,Добрич,Общо,173831,84476,89355
2018,Добрич,0,1297,666,631
2018,Добрич,1 - 4,5922,3037,2885
2018,Добрич,5 - 9,8484,4359,4125
2018,Добрич,10 - 14,8926,4624,4302
2018,Добрич,15 - 19,8328,4261,4067
2018,Добрич,20 - 24,7246,3686,3560
2018,Добрич,25 - 29,9399,4961,4438
2018,Добрич,30 - 34,10668,5665,5003
2018,Добрич,35 - 39,11036,5735,5301
2018,Добрич,40 - 44,13035,6656,6379
2018,Добрич,45 - 49,13602,6946,6656
2018,Добрич,50 - 54,12367,6275,6092
2018,Добрич,55 - 59,12834,6294,6540
2018,Добрич,60 - 64,12474,5785,6689
2018,Добрич,65 - 69,12890,5663,7227
2018,Добрич,70 - 74,10587,4375,6212
2018,Добрич,75 - 79,7334,2770,4564
2018,Добрич,80 - 84,4439,1630,2809
2018,Добрич,85 - 89,2255,849,1406
2018,Добрич,90 - 94,619,215,404
2018,Добрич,95 - 99,86,23,63
2018,Добрич,100+,3,1,2
2018,Кърджали,Общо,152873,75525,77348
2018,Кърджали,0,1457,763,694
2018,Кърджали,1 - 4,6103,3187,2916
2018,Кърджали,5 - 9,7235,3716,3519
2018,Кърджали,10 - 14,7238,3681,3557
2018,Кърджали,15 - 19,6527,3366,3161
2018,Кърджали,20 - 24,5600,2899,2701
2018,Кърджали,25 - 29,8474,4236,4238
2018,Кърджали,30 - 34,10127,4978,5149
2018,Кърджали,35 - 39,11418,5779,5639
2018,Кърджали,40 - 44,11438,6100,5338
2018,Кърджали,45 - 49,10928,5857,5071
2018,Кърджали,50 - 54,11509,5923,5586
2018,Кърджали,55 - 59,11882,5968,5914
2018,Кърджали,60 - 64,12271,5841,6430
2018,Кърджали,65 - 69,10640,4929,5711
2018,Кърджали,70 - 74,7226,3192,4034
2018,Кърджали,75 - 79,5965,2475,3490
2018,Кърджали,80 - 84,4327,1720,2607
2018,Кърджали,85 - 89,1860,696,1164
2018,Кърджали,90 - 94,559,198,361
2018,Кърджали,95 - 99,78,20,58
2018,Кърджали,100+,11,1,10
2018,Кюстендил,Общо,119041,57944,61097
2018,Кюстендил,0,831,414,417
2018,Кюстендил,1 - 4,3580,1836,1744
2018,Кюстендил,5 - 9,4820,2484,2336
2018,Кюстендил,10 - 14,5120,2643,2477
2018,Кюстендил,15 - 19,4811,2511,2300
2018,Кюстендил,20 - 24,3371,1820,1551
2018,Кюстендил,25 - 29,4915,2723,2192
2018,Кюстендил,30 - 34,6304,3379,2925
2018,Кюстендил,35 - 39,7432,4006,3426
2018,Кюстендил,40 - 44,8746,4577,4169
2018,Кюстендил,45 - 49,9189,4774,4415
2018,Кюстендил,50 - 54,8923,4610,4313
2018,Кюстендил,55 - 59,9192,4565,4627
2018,Кюстендил,60 - 64,9325,4383,4942
2018,Кюстендил,65 - 69,9710,4398,5312
2018,Кюстендил,70 - 74,8665,3633,5032
2018,Кюстендил,75 - 79,6316,2456,3860
2018,Кюстендил,80 - 84,4535,1646,2889
2018,Кюстендил,85 - 89,2440,846,1594
2018,Кюстендил,90 - 94,702,204,498
2018,Кюстендил,95 - 99,114,36,78
2018,Кюстендил,100+,-,-,-
2018,Ловеч,Общо,124873,60836,64037
2018,Ловеч,0,1035,516,519
2018,Ловеч,1 - 4,4132,2099,2033
2018,Ловеч,5 - 9,5684,2905,2779
2018,Ловеч,10 - 14,5898,3002,2896
2018,Ловеч,15 - 19,5820,3014,2806
2018,Ловеч,20 - 24,4489,2344,2145
2018,Ловеч,25 - 29,5868,3133,2735
2018,Ловеч,30 - 34,6460,3447,3013
2018,Ловеч,35 - 39,6842,3657,3185
2018,Ловеч,40 - 44,8678,4551,4127
2018,Ловеч,45 - 49,9410,4956,4454
2018,Ловеч,50 - 54,8886,4540,4346
2018,Ловеч,55 - 59,9069,4616,4453
2018,Ловеч,60 - 64,9089,4434,4655
2018,Ловеч,65 - 69,9485,4222,5263
2018,Ловеч,70 - 74,9317,3821,5496
2018,Ловеч,75 - 79,6421,2514,3907
2018,Ловеч,80 - 84,4839,1848,2991
2018,Ловеч,85 - 89,2642,957,1685
2018,Ловеч,90 - 94,690,221,469
2018,Ловеч,95 - 99,118,38,80
2018,Ловеч,100+,1,1,-
2018,Монтана,Общо,129637,63334,66303
2018,Монтана,0,1004,502,502
2018,Монтана,1 - 4,4394,2267,2127
2018,Монтана,5 - 9,6159,3173,2986
2018,Монтана,10 - 14,6029,3170,2859
2018,Монтана,15 - 19,6305,3171,3134
2018,Монтана,20 - 24,5035,2629,2406
2018,Монтана,25 - 29,6325,3320,3005
2018,Монтана,30 - 34,6898,3667,3231
2018,Монтана,35 - 39,7454,4004,3450
2018,Монтана,40 - 44,8768,4571,4197
2018,Монтана,45 - 49,9599,5017,4582
2018,Монтана,50 - 54,8869,4588,4281
2018,Монтана,55 - 59,9281,4759,4522
2018,Монтана,60 - 64,9484,4653,4831
2018,Монтана,65 - 69,10193,4685,5508
2018,Монтана,70 - 74,9421,3923,5498
2018,Монтана,75 - 79,6469,2430,4039
2018,Монтана,80 - 84,4645,1665,2980
2018,Монтана,85 - 89,2461,864,1597
2018,Монтана,90 - 94,739,239,500
2018,Монтана,95 - 99,103,37,66
2018,Монтана,100+,2,-,2
2018,Пазарджик,Общо,255479,125103,130376
2018,Пазарджик,0,2414,1238,1176
2018,Пазарджик,1 - 4,9792,5007,4785
2018,Пазарджик,5 - 9,13250,6872,6378
2018,Пазарджик,10 - 14,13162,6805,6357
2018,Пазарджик,15 - 19,12672,6640,6032
2018,Пазарджик,20 - 24,10449,5442,5007
2018,Пазарджик,25 - 29,14080,7257,6823
2018,Пазарджик,30 - 34,16530,8760,7770
2018,Пазарджик,35 - 39,17147,9069,8078
2018,Пазарджик,40 - 44,17895,9441,8454
2018,Пазарджик,45 - 49,18837,9653,9184
2018,Пазарджик,50 - 54,18497,9344,9153
2018,Пазарджик,55 - 59,19665,9844,9821
2018,Пазарджик,60 - 64,18566,8822,9744
2018,Пазарджик,65 - 69,16617,7390,9227
2018,Пазарджик,70 - 74,13974,5681,8293
2018,Пазарджик,75 - 79,10277,3858,6419
2018,Пазарджик,80 - 84,6996,2482,4514
2018,Пазарджик,85 - 89,3508,1178,2330
2018,Пазарджик,90 - 94,1012,275,737
2018,Пазарджик,95 - 99,133,45,88
2018,Пазарджик,100+,6,-,6
2018,Перник,Общо,120880,58824,62056
2018,Перник,0,937,482,455
2018,Перник,1 - 4,3796,1986,1810
2018,Перник,5 - 9,5178,2691,2487
2018,Перник,10 - 14,5064,2608,2456
2018,Перник,15 - 19,4600,2450,2150
2018,Перник,20 - 24,3817,2040,1777
2018,Перник,25 - 29,5208,2771,2437
2018,Перник,30 - 34,7280,3806,3474
2018,Перник,35 - 39,8460,4531,3929
2018,Перник,40 - 44,9503,4955,4548
2018,Перник,45 - 49,9078,4732,4346
2018,Перник,50 - 54,8740,4427,4313
2018,Перник,55 - 59,9314,4528,4786
2018,Перник,60 - 64,9461,4469,4992
2018,Перник,65 - 69,9103,4098,5005
2018,Перник,70 - 74,7870,3246,4624
2018,Перник,75 - 79,5803,2229,3574
2018,Перник,80 - 84,4510,1622,2888
2018,Перник,85 - 89,2383,874,1509
2018,Перник,90 - 94,681,247,434
2018,Перник,95 - 99,90,31,59
2018,Перник,100+,4,1,3
2018,Плевен,Общо,240380,116915,123465
2018,Плевен,0,1944,963,981
2018,Плевен,1 - 4,8725,4537,4188
2018,Плевен,5 - 9,11136,5684,5452
2018,Плевен,10 - 14,11599,5928,5671
2018,Плевен,15 - 19,11022,5592,5430
2018,Плевен,20 - 24,9498,4812,4686
2018,Плевен,25 - 29,11914,6278,5636
2018,Плевен,30 - 34,13429,7055,6374
2018,Плевен,35 - 39,13757,7268,6489
2018,Плевен,40 - 44,16223,8432,7791
2018,Плевен,45 - 49,17391,9067,8324
2018,Плевен,50 - 54,16139,8197,7942
2018,Плевен,55 - 59,17039,8642,8397
2018,Плевен,60 - 64,18003,8745,9258
2018,Плевен,65 - 69,18593,8585,10008
2018,Плевен,70 - 74,17655,7484,10171
2018,Плевен,75 - 79,11758,4540,7218
2018,Плевен,80 - 84,8480,3028,5452
2018,Плевен,85 - 89,4556,1585,2971
2018,Плевен,90 - 94,1330,429,901
2018,Плевен,95 - 99,180,60,120
2018,Плевен,100+,9,4,5
2018,Пловдив,Общо,668334,321176,347158
2018,Пловдив,0,6330,3255,3075
2018,Пловдив,1 - 4,26501,13593,12908
2018,Пловдив,5 - 9,33684,17415,16269
2018,Пловдив,10 - 14,31669,16311,15358
2018,Пловдив,15 - 19,29977,15383,14594
2018,Пловдив,20 - 24,30973,15829,15144
2018,Пловдив,25 - 29,41171,20731,20440
2018,Пловдив,30 - 34,47131,23845,23286
2018,Пловдив,35 - 39,48187,24909,23278
2018,Пловдив,40 - 44,51854,26518,25336
2018,Пловдив,45 - 49,48318,24459,23859
2018,Пловдив,50 - 54,44044,21724,22320
2018,Пловдив,55 - 59,45205,21822,23383
2018,Пловдив,60 - 64,44233,20662,23571
2018,Пловдив,65 - 69,42091,18373,23718
2018,Пловдив,70 - 74,36210,14740,21470
2018,Пловдив,75 - 79,26482,9936,16546
2018,Пловдив,80 - 84,19960,6945,13015
2018,Пловдив,85 - 89,10732,3615,7117
2018,Пловдив,90 - 94,3100,977,2123
2018,Пловдив,95 - 99,457,129,328
2018,Пловдив,100+,25,5,20
2018,Разград,Общо,112229,54714,57515
2018,Разград,0,938,496,442
2018,Разград,1 - 4,3888,1992,1896
2018,Разград,5 - 9,5220,2659,2561
2018,Разград,10 - 14,5384,2766,2618
2018,Разград,15 - 19,5520,2865,2655
2018,Разград,20 - 24,4838,2529,2309
2018,Разград,25 - 29,5988,3045,2943
2018,Разград,30 - 34,6471,3384,3087
2018,Разград,35 - 39,7135,3713,3422
2018,Разград,40 - 44,8220,4240,3980
2018,Разград,45 - 49,9012,4692,4320
2018,Разград,50 - 54,8589,4415,4174
2018,Разград,55 - 59,8408,4170,4238
2018,Разград,60 - 64,8381,3978,4403
2018,Разград,65 - 69,8089,3631,4458
2018,Разград,70 - 74,7030,2812,4218
2018,Разград,75 - 79,4701,1758,2943
2018,Разград,80 - 84,2795,1047,1748
2018,Разград,85 - 89,1257,421,836
2018,Разград,90 - 94,321,95,226
2018,Разград,95 - 99,38,6,32
2018,Разград,100+,6,-,6
2018,Русе,Общо,218556,106679,111877
2018,Русе,0,1683,850,833
2018,Русе,1 - 4,7213,3806,3407
2018,Русе,5 - 9,9483,4921,4562
2018,Русе,10 - 14,9496,4873,4623
2018,Русе,15 - 19,9215,4778,4437
2018,Русе,20 - 24,10100,5371,4729
2018,Русе,25 - 29,13451,7377,6074
2018,Русе,30 - 34,14200,7488,6712
2018,Русе,35 - 39,14069,7441,6628
2018,Русе,40 - 44,16292,8382,7910
2018,Русе,45 - 49,16095,8185,7910
2018,Русе,50 - 54,15104,7596,7508
2018,Русе,55 - 59,15283,7614,7669
2018,Русе,60 - 64,15889,7597,8292
2018,Русе,65 - 69,15680,6964,8716
2018,Русе,70 - 74,14346,5788,8558
2018,Русе,75 - 79,9971,3812,6159
2018,Русе,80 - 84,6494,2292,4202
2018,Русе,85 - 89,3425,1191,2234
2018,Русе,90 - 94,941,311,630
2018,Русе,95 - 99,121,40,81
2018,Русе,100+,5,2,3
2018,Силистра,Общо,109271,53464,55807
2018,Силистра,0,818,437,381
2018,Силистра,1 - 4,3892,1978,1914
2018,Силистра,5 - 9,5129,2641,2488
2018,Силистра,10 - 14,5133,2712,2421
2018,Силистра,15 - 19,5098,2653,2445
2018,Силистра,20 - 24,4252,2129,2123
2018,Силистра,25 - 29,5662,2928,2734
2018,Силистра,30 - 34,6393,3445,2948
2018,Силистра,35 - 39,6470,3402,3068
2018,Силистра,40 - 44,7500,3849,3651
2018,Силистра,45 - 49,8085,4228,3857
2018,Силистра,50 - 54,8235,4160,4075
2018,Силистра,55 - 59,8301,4215,4086
2018,Силистра,60 - 64,8069,3792,4277
2018,Силистра,65 - 69,8562,3846,4716
2018,Силистра,70 - 74,7415,3140,4275
2018,Силистра,75 - 79,5444,2186,3258
2018,Силистра,80 - 84,3042,1124,1918
2018,Силистра,85 - 89,1360,488,872
2018,Силистра,90 - 94,348,95,253
2018,Силистра,95 - 99,59,15,44
2018,Силистра,100+,4,1,3
2018,Сливен,Общо,186495,90636,95859
2018,Сливен,0,2258,1216,1042
2018,Сливен,1 - 4,9431,4850,4581
2018,Сливен,5 - 9,11358,5775,5583
2018,Сливен,10 - 14,11463,5757,5706
2018,Сливен,15 - 19,10752,5561,5191
2018,Сливен,20 - 24,8600,4463,4137
2018,Сливен,25 - 29,10302,5325,4977
2018,Сливен,30 - 34,11140,5919,5221
2018,Сливен,35 - 39,11947,6233,5714
2018,Сливен,40 - 44,13279,6685,6594
2018,Сливен,45 - 49,12385,6254,6131
2018,Сливен,50 - 54,11771,5885,5886
2018,Сливен,55 - 59,12509,6227,6282
2018,Сливен,60 - 64,12415,5868,6547
2018,Сливен,65 - 69,12024,5234,6790
2018,Сливен,70 - 74,9953,4069,5884
2018,Сливен,75 - 79,6768,2503,4265
2018,Сливен,80 - 84,4999,1753,3246
2018,Сливен,85 - 89,2402,830,1572
2018,Сливен,90 - 94,661,205,456
2018,Сливен,95 - 99,74,23,51
2018,Сливен,100+,4,1,3
2018,Смолян,Общо,105421,50959,54462
2018,Смолян,0,685,369,316
2018,Смолян,1 - 4,2959,1440,1519
2018,Смолян,5 - 9,4056,2051,2005
2018,Смолян,10 - 14,4413,2310,2103
2018,Смолян,15 - 19,4174,2198,1976
2018,Смолян,20 - 24,2999,1576,1423
2018,Смолян,25 - 29,4696,2523,2173
2018,Смолян,30 - 34,6414,3477,2937
2018,Смолян,35 - 39,7041,3775,3266
2018,Смолян,40 - 44,7498,3911,3587
2018,Смолян,45 - 49,7801,3955,3846
2018,Смолян,50 - 54,8488,4290,4198
2018,Смолян,55 - 59,9430,4672,4758
2018,Смолян,60 - 64,9661,4444,5217
2018,Смолян,65 - 69,8661,3801,4860
2018,Смолян,70 - 74,6519,2596,3923
2018,Смолян,75 - 79,4714,1792,2922
2018,Смолян,80 - 84,3157,1153,2004
2018,Смолян,85 - 89,1551,489,1062
2018,Смолян,90 - 94,429,121,308
2018,Смолян,95 - 99,70,14,56
2018,Смолян,100+,5,2,3
2018,София,Общо,229041,112497,116544
2018,София,0,1984,1051,933
2018,София,1 - 4,8097,4127,3970
2018,София,5 - 9,10597,5411,5186
2018,София,10 - 14,10817,5567,5250
2018,София,15 - 19,10409,5455,4954
2018,София,20 - 24,9200,4735,4465
2018,София,25 - 29,11461,6025,5436
2018,София,30 - 34,13705,7359,6346
2018,София,35 - 39,15064,8044,7020
2018,София,40 - 44,17039,8940,8099
2018,София,45 - 49,17603,9096,8507
2018,София,50 - 54,16569,8557,8012
2018,София,55 - 59,16362,8317,8045
2018,София,60 - 64,16337,7840,8497
2018,София,65 - 69,16432,7379,9053
2018,София,70 - 74,14525,6229,8296
2018,София,75 - 79,10041,3916,6125
2018,София,80 - 84,7504,2626,4878
2018,София,85 - 89,4048,1417,2631
2018,София,90 - 94,1084,356,728
2018,София,95 - 99,155,46,109
2018,София,100+,8,4,4
2018,София (столица),Общо,1328120,636963,691157
2018,София (столица),0,12891,6699,6192
2018,София (столица),1 - 4,54172,27838,26334
2018,София (столица),5 - 9,67845,34800,33045
2018,София (столица),10 - 14,58593,30125,28468
2018,София (столица),15 - 19,54739,28064,26675
2018,София (столица),20 - 24,74623,38165,36458
2018,София (столица),25 - 29,103428,52501,50927
2018,София (столица),30 - 34,117341,59546,57795
2018,София (столица),35 - 39,109802,55216,54586
2018,София (столица),40 - 44,117657,59271,58386
2018,София (столица),45 - 49,97915,49103,48812
2018,София (столица),50 - 54,77669,38291,39378
2018,София (столица),55 - 59,73932,34627,39305
2018,София (столица),60 - 64,75574,33201,42373
2018,София (столица),65 - 69,75941,31503,44438
2018,София (столица),70 - 74,61154,24407,36747
2018,София (столица),75 - 79,40600,15498,25102
2018,София (столица),80 - 84,29422,10166,19256
2018,София (столица),85 - 89,17346,5605,11741
2018,София (столица),90 - 94,6338,1988,4350
2018,София (столица),95 - 99,1094,332,762
2018,София (столица),100+,44,17,27
2018,Стара Загора,Общо,316356,153264,163092
2018,Стара Загора,0,2942,1522,1420
2018,Стара Загора,1 - 4,12434,6428,6006
2018,Стара Загора,5 - 9,16311,8438,7873
2018,Стара Загора,10 - 14,15611,8109,7502
2018,Стара Загора,15 - 19,14975,7703,7272
2018,Стара Загора,20 - 24,12866,6457,6409
2018,Стара Загора,25 - 29,17033,8527,8506
2018,Стара Загора,30 - 34,19853,10268,9585
2018,Стара Загора,35 - 39,21507,11444,10063
2018,Стара Загора,40 - 44,24363,12696,11667
2018,Стара Загора,45 - 49,23093,11956,11137
2018,Стара Загора,50 - 54,21116,10750,10366
2018,Стара Загора,55 - 59,21729,10717,11012
2018,Стара Загора,60 - 64,22034,10270,11764
2018,Стара Загора,65 - 69,21964,9591,12373
2018,Стара Загора,70 - 74,18599,7568,11031
2018,Стара Загора,75 - 79,13309,5042,8267
2018,Стара Загора,80 - 84,9909,3567,6342
2018,Стара Загора,85 - 89,5155,1729,3426
2018,Стара Загора,90 - 94,1346,425,921
2018,Стара Загора,95 - 99,196,55,141
2018,Стара Загора,100+,11,2,9
2018,Търговище,Общо,111597,54512,57085
2018,Търговище,0,964,506,458
2018,Търговище,1 - 4,4157,2074,2083
2018,Търговище,5 - 9,5703,2950,2753
2018,Търговище,10 - 14,5725,2929,2796
2018,Търговище,15 - 19,5497,2793,2704
2018,Търговище,20 - 24,4754,2428,2326
2018,Търговище,25 - 29,6143,3176,2967
2018,Търговище,30 - 34,6477,3362,3115
2018,Търговище,35 - 39,7285,3826,3459
2018,Търговище,40 - 44,8142,4159,3983
2018,Търговище,45 - 49,8375,4420,3955
2018,Търговище,50 - 54,8109,4172,3937
2018,Търговище,55 - 59,8293,4131,4162
2018,Търговище,60 - 64,8079,3958,4121
2018,Търговище,65 - 69,7681,3389,4292
2018,Търговище,70 - 74,6624,2701,3923
2018,Търговище,75 - 79,4729,1819,2910
2018,Търговище,80 - 84,2970,1083,1887
2018,Търговище,85 - 89,1429,507,922
2018,Търговище,90 - 94,391,113,278
2018,Търговище,95 - 99,67,15,52
2018,Търговище,100+,3,1,2
2018,Хасково,Общо,228141,111377,116764
2018,Хасково,0,1835,924,911
2018,Хасково,1 - 4,8593,4388,4205
2018,Хасково,5 - 9,11541,5837,5704
2018,Хасково,10 - 14,11198,5767,5431
2018,Хасково,15 - 19,10486,5363,5123
2018,Хасково,20 - 24,9132,4783,4349
2018,Хасково,25 - 29,11315,6019,5296
2018,Хасково,30 - 34,14088,7405,6683
2018,Хасково,35 - 39,15576,8243,7333
2018,Хасково,40 - 44,17103,8928,8175
2018,Хасково,45 - 49,16516,8567,7949
2018,Хасково,50 - 54,15681,7906,7775
2018,Хасково,55 - 59,16318,8067,8251
2018,Хасково,60 - 64,17186,8197,8989
2018,Хасково,65 - 69,16229,7332,8897
2018,Хасково,70 - 74,12998,5486,7512
2018,Хасково,75 - 79,9505,3678,5827
2018,Хасково,80 - 84,7385,2613,4772
2018,Хасково,85 - 89,4111,1440,2671
2018,Хасково,90 - 94,1200,398,802
2018,Хасково,95 - 99,137,35,102
2018,Хасково,100+,8,1,7
2018,Шумен,Общо,172355,84145,88210
2018,Шумен,0,1446,779,667
2018,Шумен,1 - 4,5989,3086,2903
2018,Шумен,5 - 9,8362,4256,4106
2018,Шумен,10 - 14,8285,4328,3957
2018,Шумен,15 - 19,8337,4292,4045
2018,Шумен,20 - 24,7464,3840,3624
2018,Шумен,25 - 29,10367,5359,5008
2018,Шумен,30 - 34,11016,5597,5419
2018,Шумен,35 - 39,11413,5828,5585
2018,Шумен,40 - 44,13060,6724,6336
2018,Шумен,45 - 49,13284,6976,6308
2018,Шумен,50 - 54,11956,6127,5829
2018,Шумен,55 - 59,12325,6166,6159
2018,Шумен,60 - 64,12168,5802,6366
2018,Шумен,65 - 69,12630,5673,6957
2018,Шумен,70 - 74,10196,4205,5991
2018,Шумен,75 - 79,6645,2517,4128
2018,Шумен,80 - 84,4503,1579,2924
2018,Шумен,85 - 89,2218,807,1411
2018,Шумен,90 - 94,608,177,431
2018,Шумен,95 - 99,78,25,53
2018,Шумен,100+,5,2,3
2018,Ямбол,Общо,118897,58200,60697
2018,Ямбол,0,1157,589,568
2018,Ямбол,1 - 4,4602,2327,2275
2018,Ямбол,5 - 9,6026,3073,2953
2018,Ямбол,10 - 14,6108,3103,3005
2018,Ямбол,15 - 19,5676,2970,2706
2018,Ямбол,20 - 24,4404,2338,2066
2018,Ямбол,25 - 29,5807,3054,2753
2018,Ямбол,30 - 34,6932,3687,3245
2018,Ямбол,35 - 39,7356,3967,3389
2018,Ямбол,40 - 44,8219,4221,3998
2018,Ямбол,45 - 49,8125,4164,3961
2018,Ямбол,50 - 54,7970,4025,3945
2018,Ямбол,55 - 59,8939,4467,4472
2018,Ямбол,60 - 64,8935,4357,4578
2018,Ямбол,65 - 69,9153,4223,4930
2018,Ямбол,70 - 74,7348,3073,4275
2018,Ямбол,75 - 79,5340,2075,3265
2018,Ямбол,80 - 84,4132,1545,2587
2018,Ямбол,85 - 89,2033,722,1311
2018,Ямбол,90 - 94,567,194,373
2018,Ямбол,95 - 99,65,25,40
2018,Ямбол,100+,3,1,2
2019,Благоевград,Общо,302694,147231,155463
2019,Благоевград,0,2802,1391,1411
2019,Благоевград,1 - 4,11226,5722,5504
2019,Благоевград,5 - 9,14796,7592,7204
2019,Благоевград,10 - 14,15733,8091,7642
2019,Благоевград,15 - 19,13769,7090,6679
2019,Благоевград,20 - 24,11373,5866,5507
2019,Благоевград,25 - 29,17878,8914,8964
2019,Благоевград,30 - 34,22075,11074,11001
2019,Благоевград,35 - 39,21370,11161,10209
2019,Благоевград,40 - 44,22244,11352,10892
2019,Благоевград,45 - 49,22219,11397,10822
2019,Благоевград,50 - 54,22678,11169,11509
2019,Благоевград,55 - 59,22949,11156,11793
2019,Благоевград,60 - 64,21743,10312,11431
2019,Благоевград,65 - 69,19406,8924,10482
2019,Благоевград,70 - 74,15745,6781,8964
2019,Благоевград,75 - 79,11432,4412,7020
2019,Благоевград,80 - 84,7841,2938,4903
2019,Благоевград,85 - 89,4250,1498,2752
2019,Благоевград,90 - 94,983,342,641
2019,Благоевград,95 - 99,174,47,127
2019,Благоевград,100+,8,2,6
2019,Бургас,Общо,409265,197790,211475
2019,Бургас,0,3753,1947,1806
2019,Бургас,1 - 4,16011,8142,7869
2019,Бургас,5 - 9,21258,10978,10280
2019,Бургас,10 - 14,22851,11710,11141
2019,Бургас,15 - 19,19474,9898,9576
2019,Бургас,20 - 24,16589,8464,8125
2019,Бургас,25 - 29,21138,10591,10547
2019,Бургас,30 - 34,27639,13877,13762
2019,Бургас,35 - 39,29911,15479,14432
2019,Бургас,40 - 44,32960,16901,16059
2019,Бургас,45 - 49,32327,16473,15854
2019,Бургас,50 - 54,27929,13915,14014
2019,Бургас,55 - 59,27813,13460,14353
2019,Бургас,60 - 64,28089,12912,15177
2019,Бургас,65 - 69,27008,11991,15017
2019,Бургас,70 - 74,22810,9494,13316
2019,Бургас,75 - 79,14583,5667,8916
2019,Бургас,80 - 84,10043,3507,6536
2019,Бургас,85 - 89,5317,1817,3500
2019,Бургас,90 - 94,1545,501,1044
2019,Бургас,95 - 99,205,60,145
2019,Бургас,100+,12,6,6
2019,Варна,Общо,469885,228712,241173
2019,Варна,0,4284,2197,2087
2019,Варна,1 - 4,17990,9258,8732
2019,Варна,5 - 9,24147,12499,11648
2019,Варна,10 - 14,25108,12878,12230
2019,Варна,15 - 19,21525,11104,10421
2019,Варна,20 - 24,21517,11412,10105
2019,Варна,25 - 29,27875,14321,13554
2019,Варна,30 - 34,35129,17635,17494
2019,Варна,35 - 39,35906,18358,17548
2019,Варна,40 - 44,39899,20429,19470
2019,Варна,45 - 49,37279,18927,18352
2019,Варна,50 - 54,30810,15606,15204
2019,Варна,55 - 59,29120,14173,14947
2019,Варна,60 - 64,28899,13446,15453
2019,Варна,65 - 69,28784,12644,16140
2019,Варна,70 - 74,25327,10464,14863
2019,Варна,75 - 79,17032,6764,10268
2019,Варна,80 - 84,10931,3884,7047
2019,Варна,85 - 89,6317,2081,4236
2019,Варна,90 - 94,1750,555,1195
2019,Варна,95 - 99,238,70,168
2019,Варна,100+,18,7,11
2019,Велико Търново,Общо,232568,112401,120167
2019,Велико Търново,0,1687,872,815
2019,Велико Търново,1 - 4,7760,3962,3798
2019,Велико Търново,5 - 9,10230,5217,5013
2019,Велико Търново,10 - 14,10063,5201,4862
2019,Велико Търново,15 - 19,10100,5133,4967
2019,Велико Търново,20 - 24,10822,5421,5401
2019,Велико Търново,25 - 29,15307,7796,7511
2019,Велико Търново,30 - 34,16463,8629,7834
2019,Велико Търново,35 - 39,14365,7447,6918
2019,Велико Търново,40 - 44,16377,8372,8005
2019,Велико Търново,45 - 49,16288,8515,7773
2019,Велико Търново,50 - 54,15126,7543,7583
2019,Велико Търново,55 - 59,15783,7784,7999
2019,Велико Търново,60 - 64,16637,7911,8726
2019,Велико Търново,65 - 69,16828,7569,9259
2019,Велико Търново,70 - 74,15773,6665,9108
2019,Велико Търново,75 - 79,11080,4295,6785
2019,Велико Търново,80 - 84,6785,2382,4403
2019,Велико Търново,85 - 89,3950,1324,2626
2019,Велико Търново,90 - 94,986,320,666
2019,Велико Търново,95 - 99,153,41,112
2019,Велико Търново,100+,5,2,3
2019,Видин,Общо,82835,40369,42466
2019,Видин,0,543,259,284
2019,Видин,1 - 4,2251,1179,1072
2019,Видин,5 - 9,3419,1736,1683
2019,Видин,10 - 14,3762,1944,1818
2019,Видин,15 - 19,3710,1901,1809
2019,Видин,20 - 24,2643,1367,1276
2019,Видин,25 - 29,3299,1765,1534
2019,Видин,30 - 34,3963,2105,1858
2019,Видин,35 - 39,4386,2349,2037
2019,Видин,40 - 44,5661,2977,2684
2019,Видин,45 - 49,6604,3509,3095
2019,Видин,50 - 54,6030,3178,2852
2019,Видин,55 - 59,5889,3061,2828
2019,Видин,60 - 64,5874,2899,2975
2019,Видин,65 - 69,6868,3094,3774
2019,Видин,70 - 74,7453,3178,4275
2019,Видин,75 - 79,4883,1911,2972
2019,Видин,80 - 84,3258,1192,2066
2019,Видин,85 - 89,1706,566,1140
2019,Видин,90 - 94,555,182,373
2019,Видин,95 - 99,74,17,57
2019,Видин,100+,4,-,4
2019,Враца,Общо,159470,78234,81236
2019,Враца,0,1342,672,670
2019,Враца,1 - 4,5506,2853,2653
2019,Враца,5 - 9,7384,3888,3496
2019,Враца,10 - 14,7712,3925,3787
2019,Враца,15 - 19,7615,3906,3709
2019,Враца,20 - 24,6251,3208,3043
2019,Враца,25 - 29,7593,4007,3586
2019,Враца,30 - 34,8658,4623,4035
2019,Враца,35 - 39,9191,4861,4330
2019,Враца,40 - 44,11109,5775,5334
2019,Враца,45 - 49,12273,6408,5865
2019,Враца,50 - 54,12176,6387,5789
2019,Враца,55 - 59,11839,6119,5720
2019,Враца,60 - 64,11732,5705,6027
2019,Враца,65 - 69,11551,5292,6259
2019,Враца,70 - 74,11430,4758,6672
2019,Враца,75 - 79,7537,2908,4629
2019,Враца,80 - 84,4864,1750,3114
2019,Враца,85 - 89,2798,949,1849
2019,Враца,90 - 94,788,214,574
2019,Враца,95 - 99,117,26,91
2019,Враца,100+,4,-,4
2019,Габрово,Общо,106598,51298,55300
2019,Габрово,0,747,381,366
2019,Габрово,1 - 4,3041,1562,1479
2019,Габрово,5 - 9,4248,2187,2061
2019,Габрово,10 - 14,4441,2280,2161
2019,Габрово,15 - 19,4073,2106,1967
2019,Габрово,20 - 24,3304,1717,1587
2019,Габрово,25 - 29,4720,2671,2049
2019,Габрово,30 - 34,5717,3120,2597
2019,Габрово,35 - 39,6061,3257,2804
2019,Габрово,40 - 44,7726,4016,3710
2019,Габрово,45 - 49,8098,4185,3913
2019,Габрово,50 - 54,7648,3866,3782
2019,Габрово,55 - 59,7913,3899,4014
2019,Габрово,60 - 64,7897,3774,4123
2019,Габрово,65 - 69,8592,3733,4859
2019,Габрово,70 - 74,8945,3636,5309
2019,Габрово,75 - 79,6065,2357,3708
2019,Габрово,80 - 84,4192,1509,2683
2019,Габрово,85 - 89,2411,815,1596
2019,Габрово,90 - 94,629,191,438
2019,Габрово,95 - 99,126,34,92
2019,Габрово,100+,4,2,2
2019,Добрич,Общо,171809,83378,88431
2019,Добрич,0,1356,692,664
2019,Добрич,1 - 4,5698,2926,2772
2019,Добрич,5 - 9,8194,4193,4001
2019,Добрич,10 - 14,9028,4669,4359
2019,Добрич,15 - 19,8303,4264,4039
2019,Добрич,20 - 24,7045,3588,3457
2019,Добрич,25 - 29,8820,4618,4202
2019,Добрич,30 - 34,10526,5584,4942
2019,Добрич,35 - 39,10682,5564,5118
2019,Добрич,40 - 44,12438,6371,6067
2019,Добрич,45 - 49,13534,6893,6641
2019,Добрич,50 - 54,12711,6464,6247
2019,Добрич,55 - 59,12754,6294,6460
2019,Добрич,60 - 64,12237,5712,6525
2019,Добрич,65 - 69,12503,5468,7035
2019,Добрич,70 - 74,11085,4560,6525
2019,Добрич,75 - 79,7511,2845,4666
2019,Добрич,80 - 84,4364,1601,2763
2019,Добрич,85 - 89,2259,808,1451
2019,Добрич,90 - 94,653,234,419
2019,Добрич,95 - 99,102,28,74
2019,Добрич,100+,6,2,4
2019,Кърджали,Общо,158204,78102,80102
2019,Кърджали,0,1488,774,714
2019,Кърджали,1 - 4,6499,3403,3096
2019,Кърджали,5 - 9,7273,3779,3494
2019,Кърджали,10 - 14,7345,3744,3601
2019,Кърджали,15 - 19,6587,3385,3202
2019,Кърджали,20 - 24,5329,2737,2592
2019,Кърджали,25 - 29,8071,3936,4135
2019,Кърджали,30 - 34,10377,4977,5400
2019,Кърджали,35 - 39,11416,5686,5730
2019,Кърджали,40 - 44,11871,6321,5550
2019,Кърджали,45 - 49,11139,5956,5183
2019,Кърджали,50 - 54,11866,6115,5751
2019,Кърджали,55 - 59,12746,6464,6282
2019,Кърджали,60 - 64,13423,6429,6994
2019,Кърджали,65 - 69,11623,5495,6128
2019,Кърджали,70 - 74,8148,3669,4479
2019,Кърджали,75 - 79,6042,2527,3515
2019,Кърджали,80 - 84,4086,1653,2433
2019,Кърджали,85 - 89,2198,836,1362
2019,Кърджали,90 - 94,569,184,385
2019,Кърджали,95 - 99,96,30,66
2019,Кърджали,100+,12,2,10
2019,Кюстендил,Общо,116915,56922,59993
2019,Кюстендил,0,869,429,440
2019,Кюстендил,1 - 4,3442,1733,1709
2019,Кюстендил,5 - 9,4792,2502,2290
2019,Кюстендил,10 - 14,5082,2600,2482
2019,Кюстендил,15 - 19,4702,2444,2258
2019,Кюстендил,20 - 24,3269,1791,1478
2019,Кюстендил,25 - 29,4578,2545,2033
2019,Кюстендил,30 - 34,6079,3276,2803
2019,Кюстендил,35 - 39,7043,3825,3218
2019,Кюстендил,40 - 44,8486,4510,3976
2019,Кюстендил,45 - 49,9046,4723,4323
2019,Кюстендил,50 - 54,9060,4639,4421
2019,Кюстендил,55 - 59,9159,4637,4522
2019,Кюстендил,60 - 64,8969,4208,4761
2019,Кюстендил,65 - 69,9373,4213,5160
2019,Кюстендил,70 - 74,8991,3772,5219
2019,Кюстендил,75 - 79,6260,2410,3850
2019,Кюстендил,80 - 84,4377,1584,2793
2019,Кюстендил,85 - 89,2496,847,1649
2019,Кюстендил,90 - 94,731,212,519
2019,Кюстендил,95 - 99,109,21,88
2019,Кюстендил,100+,2,1,1
2019,Ловеч,Общо,122546,59658,62888
2019,Ловеч,0,974,511,463
2019,Ловеч,1 - 4,4102,2085,2017
2019,Ловеч,5 - 9,5519,2820,2699
2019,Ловеч,10 - 14,5921,3004,2917
2019,Ловеч,15 - 19,5695,2944,2751
2019,Ловеч,20 - 24,4297,2244,2053
2019,Ловеч,25 - 29,5605,3006,2599
2019,Ловеч,30 - 34,6319,3372,2947
2019,Ловеч,35 - 39,6617,3529,3088
2019,Ловеч,40 - 44,8230,4337,3893
2019,Ловеч,45 - 49,9268,4856,4412
2019,Ловеч,50 - 54,9056,4641,4415
2019,Ловеч,55 - 59,8961,4601,4360
2019,Ловеч,60 - 64,8864,4299,4565
2019,Ловеч,65 - 69,8995,4056,4939
2019,Ловеч,70 - 74,9531,3860,5671
2019,Ловеч,75 - 79,6387,2492,3895
2019,Ловеч,80 - 84,4643,1742,2901
2019,Ловеч,85 - 89,2717,974,1743
2019,Ловеч,90 - 94,706,242,464
2019,Ловеч,95 - 99,130,39,91
2019,Ловеч,100+,9,4,5
2019,Монтана,Общо,127001,62121,64880
2019,Монтана,0,936,487,449
2019,Монтана,1 - 4,4217,2153,2064
2019,Монтана,5 - 9,6015,3129,2886
2019,Монтана,10 - 14,6127,3206,2921
2019,Монтана,15 - 19,6045,3084,2961
2019,Монтана,20 - 24,4858,2533,2325
2019,Монтана,25 - 29,6055,3170,2885
2019,Монтана,30 - 34,6748,3589,3159
2019,Монтана,35 - 39,7121,3802,3319
2019,Монтана,40 - 44,8450,4417,4033
2019,Монтана,45 - 49,9453,4952,4501
2019,Монтана,50 - 54,8930,4636,4294
2019,Монтана,55 - 59,9192,4699,4493
2019,Монтана,60 - 64,9194,4529,4665
2019,Монтана,65 - 69,9729,4505,5224
2019,Монтана,70 - 74,9685,4066,5619
2019,Монтана,75 - 79,6406,2464,3942
2019,Монтана,80 - 84,4519,1557,2962
2019,Монтана,85 - 89,2525,884,1641
2019,Монтана,90 - 94,702,228,474
2019,Монтана,95 - 99,92,29,63
2019,Монтана,100+,2,2,-
2019,Пазарджик,Общо,252776,123715,129061
2019,Пазарджик,0,2297,1185,1112
2019,Пазарджик,1 - 4,9628,4991,4637
2019,Пазарджик,5 - 9,13071,6699,6372
2019,Пазарджик,10 - 14,13263,6853,6410
2019,Пазарджик,15 - 19,12532,6532,6000
2019,Пазарджик,20 - 24,10259,5354,4905
2019,Пазарджик,25 - 29,13202,6825,6377
2019,Пазарджик,30 - 34,16183,8483,7700
2019,Пазарджик,35 - 39,16742,8907,7835
2019,Пазарджик,40 - 44,17691,9358,8333
2019,Пазарджик,45 - 49,18402,9504,8898
2019,Пазарджик,50 - 54,18620,9418,9202
2019,Пазарджик,55 - 59,19211,9549,9662
2019,Пазарджик,60 - 64,18967,9081,9886
2019,Пазарджик,65 - 69,16177,7205,8972
2019,Пазарджик,70 - 74,14583,5998,8585
2019,Пазарджик,75 - 79,10154,3804,6350
2019,Пазарджик,80 - 84,6895,2403,4492
2019,Пазарджик,85 - 89,3708,1228,2480
2019,Пазарджик,90 - 94,1032,289,743
2019,Пазарджик,95 - 99,151,48,103
2019,Пазарджик,100+,8,1,7
2019,Перник,Общо,119190,57932,61258
2019,Перник,0,878,444,434
2019,Перник,1 - 4,3773,1965,1808
2019,Перник,5 - 9,4968,2613,2355
2019,Перник,10 - 14,5243,2691,2552
2019,Перник,15 - 19,4472,2385,2087
2019,Перник,20 - 24,3813,2014,1799
2019,Перник,25 - 29,4980,2659,2321
2019,Перник,30 - 34,6878,3609,3269
2019,Перник,35 - 39,8224,4380,3844
2019,Перник,40 - 44,9265,4865,4400
2019,Перник,45 - 49,9112,4725,4387
2019,Перник,50 - 54,8791,4499,4292
2019,Перник,55 - 59,9145,4412,4733
2019,Перник,60 - 64,9374,4438,4936
2019,Перник,65 - 69,8708,3923,4785
2019,Перник,70 - 74,8074,3358,4716
2019,Перник,75 - 79,5780,2197,3583
2019,Перник,80 - 84,4363,1555,2808
2019,Перник,85 - 89,2526,912,1614
2019,Перник,90 - 94,714,254,460
2019,Перник,95 - 99,103,32,71
2019,Перник,100+,6,2,4
2019,Плевен,Общо,236305,114729,121576
2019,Плевен,0,1996,1006,990
2019,Плевен,1 - 4,8425,4330,4095
2019,Плевен,5 - 9,10979,5640,5339
2019,Плевен,10 - 14,11550,5860,5690
2019,Плевен,15 - 19,10977,5590,5387
2019,Плевен,20 - 24,9225,4657,4568
2019,Плевен,25 - 29,11307,5860,5447
2019,Плевен,30 - 34,13072,6851,6221
2019,Плевен,35 - 39,13315,7024,6291
2019,Плевен,40 - 44,15540,8146,7394
2019,Плевен,45 - 49,17070,8881,8189
2019,Плевен,50 - 54,16467,8388,8079
2019,Плевен,55 - 59,16543,8418,8125
2019,Плевен,60 - 64,17837,8670,9167
2019,Плевен,65 - 69,17663,8159,9504
2019,Плевен,70 - 74,17862,7584,10278
2019,Плевен,75 - 79,12112,4737,7375
2019,Плевен,80 - 84,8189,2844,5345
2019,Плевен,85 - 89,4605,1593,3012
2019,Плевен,90 - 94,1359,427,932
2019,Плевен,95 - 99,202,61,141
2019,Плевен,100+,10,3,7
2019,Пловдив,Общо,666801,320136,346665
2019,Пловдив,0,6206,3147,3059
2019,Пловдив,1 - 4,26297,13465,12832
2019,Пловдив,5 - 9,33443,17315,16128
2019,Пловдив,10 - 14,32622,16824,15798
2019,Пловдив,15 - 19,30137,15363,14774
2019,Пловдив,20 - 24,30596,15633,14963
2019,Пловдив,25 - 29,38832,19575,19257
2019,Пловдив,30 - 34,47285,23765,23520
2019,Пловдив,35 - 39,47458,24583,22875
2019,Пловдив,40 - 44,51452,26303,25149
2019,Пловдив,45 - 49,48425,24534,23891
2019,Пловдив,50 - 54,45235,22508,22727
2019,Пловдив,55 - 59,44383,21365,23018
2019,Пловдив,60 - 64,44671,20829,23842
2019,Пловдив,65 - 69,40966,17962,23004
2019,Пловдив,70 - 74,37881,15378,22503
2019,Пловдив,75 - 79,26528,9990,16538
2019,Пловдив,80 - 84,19480,6763,12717
2019,Пловдив,85 - 89,11233,3694,7539
2019,Пловдив,90 - 94,3156,1001,2155
2019,Пловдив,95 - 99,486,131,355
2019,Пловдив,100+,29,8,21
2019,Разград,Общо,110789,54012,56777
2019,Разград,0,885,445,440
2019,Разград,1 - 4,3816,1972,1844
2019,Разград,5 - 9,5055,2585,2470
2019,Разград,10 - 14,5360,2751,2609
2019,Разград,15 - 19,5376,2799,2577
2019,Разград,20 - 24,4588,2395,2193
2019,Разград,25 - 29,5637,2896,2741
2019,Разград,30 - 34,6237,3259,2978
2019,Разград,35 - 39,6907,3553,3354
2019,Разград,40 - 44,7916,4084,3832
2019,Разград,45 - 49,8883,4607,4276
2019,Разград,50 - 54,8840,4555,4285
2019,Разград,55 - 59,8508,4305,4203
2019,Разград,60 - 64,8373,3970,4403
2019,Разград,65 - 69,7829,3535,4294
2019,Разград,70 - 74,7223,2899,4324
2019,Разград,75 - 79,4887,1817,3070
2019,Разград,80 - 84,2751,1008,1743
2019,Разград,85 - 89,1360,467,893
2019,Разград,90 - 94,298,96,202
2019,Разград,95 - 99,56,14,42
2019,Разград,100+,4,-,4
2019,Русе,Общо,215477,105026,110451
2019,Русе,0,1513,802,711
2019,Русе,1 - 4,7052,3728,3324
2019,Русе,5 - 9,9340,4879,4461
2019,Русе,10 - 14,9593,4843,4750
2019,Русе,15 - 19,9063,4736,4327
2019,Русе,20 - 24,9713,5181,4532
2019,Русе,25 - 29,12534,6866,5668
2019,Русе,30 - 34,14185,7463,6722
2019,Русе,35 - 39,13710,7247,6463
2019,Русе,40 - 44,15472,7997,7475
2019,Русе,45 - 49,16160,8178,7982
2019,Русе,50 - 54,15242,7687,7555
2019,Русе,55 - 59,15237,7552,7685
2019,Русе,60 - 64,15399,7346,8053
2019,Русе,65 - 69,15260,6855,8405
2019,Русе,70 - 74,14751,5962,8789
2019,Русе,75 - 79,10266,3928,6338
2019,Русе,80 - 84,6269,2199,4070
2019,Русе,85 - 89,3632,1214,2418
2019,Русе,90 - 94,938,323,615
2019,Русе,95 - 99,142,38,104
2019,Русе,100+,6,2,4
2019,Силистра,Общо,108018,52738,55280
2019,Силистра,0,885,467,418
2019,Силистра,1 - 4,3734,1910,1824
2019,Силистра,5 - 9,5038,2580,2458
2019,Силистра,10 - 14,5158,2698,2460
2019,Силистра,15 - 19,5042,2639,2403
2019,Силистра,20 - 24,4126,2085,2041
2019,Силистра,25 - 29,5267,2713,2554
2019,Силистра,30 - 34,6312,3346,2966
2019,Силистра,35 - 39,6360,3379,2981
2019,Силистра,40 - 44,7218,3738,3480
2019,Силистра,45 - 49,7931,4106,3825
2019,Силистра,50 - 54,8319,4235,4084
2019,Силистра,55 - 59,8367,4183,4184
2019,Силистра,60 - 64,7858,3775,4083
2019,Силистра,65 - 69,8197,3664,4533
2019,Силистра,70 - 74,7712,3262,4450
2019,Силистра,75 - 79,5602,2216,3386
2019,Силистра,80 - 84,3073,1093,1980
2019,Силистра,85 - 89,1397,528,869
2019,Силистра,90 - 94,360,102,258
2019,Силистра,95 - 99,57,17,40
2019,Силистра,100+,5,2,3
2019,Сливен,Общо,184119,89422,94697
2019,Сливен,0,2233,1146,1087
2019,Сливен,1 - 4,9231,4802,4429
2019,Сливен,5 - 9,11216,5646,5570
2019,Сливен,10 - 14,11348,5827,5521
2019,Сливен,15 - 19,10656,5455,5201
2019,Сливен,20 - 24,8466,4319,4147
2019,Сливен,25 - 29,9696,4999,4697
2019,Сливен,30 - 34,10839,5746,5093
2019,Сливен,35 - 39,11594,6072,5522
2019,Сливен,40 - 44,12878,6550,6328
2019,Сливен,45 - 49,12491,6304,6187
2019,Сливен,50 - 54,11746,5862,5884
2019,Сливен,55 - 59,12453,6219,6234
2019,Сливен,60 - 64,12047,5708,6339
2019,Сливен,65 - 69,11965,5250,6715
2019,Сливен,70 - 74,10299,4246,6053
2019,Сливен,75 - 79,6846,2499,4347
2019,Сливен,80 - 84,4805,1658,3147
2019,Сливен,85 - 89,2518,864,1654
2019,Сливен,90 - 94,702,221,481
2019,Сливен,95 - 99,86,27,59
2019,Сливен,100+,4,2,2
2019,Смолян,Общо,103532,49930,53602
2019,Смолян,0,659,343,316
2019,Смолян,1 - 4,2897,1447,1450
2019,Смолян,5 - 9,3810,1903,1907
2019,Смолян,10 - 14,4492,2348,2144
2019,Смолян,15 - 19,4033,2117,1916
2019,Смолян,20 - 24,2969,1562,1407
2019,Смолян,25 - 29,4160,2218,1942
2019,Смолян,30 - 34,5985,3236,2749
2019,Смолян,35 - 39,6842,3655,3187
2019,Смолян,40 - 44,7423,3907,3516
2019,Смолян,45 - 49,7532,3820,3712
2019,Смолян,50 - 54,8323,4217,4106
2019,Смолян,55 - 59,9140,4549,4591
2019,Смолян,60 - 64,9647,4458,5189
2019,Смолян,65 - 69,8693,3804,4889
2019,Смолян,70 - 74,6893,2780,4113
2019,Смолян,75 - 79,4660,1738,2922
2019,Смолян,80 - 84,3157,1158,1999
2019,Смолян,85 - 89,1698,532,1166
2019,Смолян,90 - 94,437,119,318
2019,Смолян,95 - 99,76,16,60
2019,Смолян,100+,6,3,3
2019,София,Общо,226671,111249,115422
2019,София,0,2083,1049,1034
2019,София,1 - 4,8024,4150,3874
2019,София,5 - 9,10380,5248,5132
2019,София,10 - 14,10979,5693,5286
2019,София,15 - 19,10180,5345,4835
2019,София,20 - 24,9078,4660,4418
2019,София,25 - 29,10987,5755,5232
2019,София,30 - 34,13330,7115,6215
2019,София,35 - 39,14623,7784,6839
2019,София,40 - 44,16650,8856,7794
2019,София,45 - 49,17546,9037,8509
2019,София,50 - 54,16800,8732,8068
2019,София,55 - 59,16573,8354,8219
2019,София,60 - 64,15957,7714,8243
2019,София,65 - 69,15871,7183,8688
2019,София,70 - 74,14960,6338,8622
2019,София,75 - 79,9950,3883,6067
2019,София,80 - 84,7293,2541,4752
2019,София,85 - 89,4098,1383,2715
2019,София,90 - 94,1144,377,767
2019,София,95 - 99,152,47,105
2019,София,100+,13,5,8
2019,София (столица),Общо,1328790,637465,691325
2019,София (столица),0,12906,6660,6246
2019,София (столица),1 - 4,53366,27537,25829
2019,София (столица),5 - 9,67728,34718,33010
2019,София (столица),10 - 14,62135,31937,30198
2019,София (столица),15 - 19,54698,28058,26640
2019,София (столица),20 - 24,73638,37614,36024
2019,София (столица),25 - 29,95154,48288,46866
2019,София (столица),30 - 34,119074,60509,58565
2019,София (столица),35 - 39,108748,54679,54069
2019,София (столица),40 - 44,116438,58533,57905
2019,София (столица),45 - 49,101612,50933,50679
2019,София (столица),50 - 54,81549,40252,41297
2019,София (столица),55 - 59,72962,34491,38471
2019,София (столица),60 - 64,73594,32528,41066
2019,София (столица),65 - 69,74593,30884,43709
2019,София (столица),70 - 74,64541,25603,38938
2019,София (столица),75 - 79,41857,16073,25784
2019,София (столица),80 - 84,28842,10085,18757
2019,София (столица),85 - 89,17734,5668,12066
2019,София (столица),90 - 94,6343,2006,4337
2019,София (столица),95 - 99,1209,383,826
2019,София (столица),100+,69,26,43
2019,Стара Загора,Общо,313396,151611,161785
2019,Стара Загора,0,2781,1392,1389
2019,Стара Загора,1 - 4,12245,6348,5897
2019,Стара Загора,5 - 9,16089,8299,7790
2019,Стара Загора,10 - 14,15889,8213,7676
2019,Стара Загора,15 - 19,14739,7657,7082
2019,Стара Загора,20 - 24,12843,6413,6430
2019,Стара Загора,25 - 29,15945,7961,7984
2019,Стара Загора,30 - 34,19633,10013,9620
2019,Стара Загора,35 - 39,20894,11080,9814
2019,Стара Загора,40 - 44,23772,12480,11292
2019,Стара Загора,45 - 49,23366,12145,11221
2019,Стара Загора,50 - 54,21402,10921,10481
2019,Стара Загора,55 - 59,21459,10551,10908
2019,Стара Загора,60 - 64,21509,10081,11428
2019,Стара Загора,65 - 69,21451,9370,12081
2019,Стара Загора,70 - 74,19470,7989,11481
2019,Стара Загора,75 - 79,13372,4991,8381
2019,Стара Загора,80 - 84,9533,3406,6127
2019,Стара Загора,85 - 89,5382,1781,3601
2019,Стара Загора,90 - 94,1420,465,955
2019,Стара Загора,95 - 99,190,53,137
2019,Стара Загора,100+,12,2,10
2019,Търговище,Общо,110914,54164,56750
2019,Търговище,0,895,468,427
2019,Търговище,1 - 4,4111,2074,2037
2019,Търговище,5 - 9,5654,2917,2737
2019,Търговище,10 - 14,5642,2859,2783
2019,Търговище,15 - 19,5496,2827,2669
2019,Търговище,20 - 24,4597,2300,2297
2019,Търговище,25 - 29,5907,3023,2884
2019,Търговище,30 - 34,6475,3372,3103
2019,Търговище,35 - 39,7059,3655,3404
2019,Търговище,40 - 44,7979,4128,3851
2019,Търговище,45 - 49,8385,4372,4013
2019,Търговище,50 - 54,8212,4254,3958
2019,Търговище,55 - 59,8316,4154,4162
2019,Търговище,60 - 64,7918,3883,4035
2019,Търговище,65 - 69,7777,3515,4262
2019,Търговище,70 - 74,6851,2819,4032
2019,Търговище,75 - 79,4806,1863,2943
2019,Търговище,80 - 84,2894,1020,1874
2019,Търговище,85 - 89,1490,542,948
2019,Търговище,90 - 94,378,104,274
2019,Търговище,95 - 99,71,15,56
2019,Търговище,100+,1,-,1
2019,Хасково,Общо,225317,109971,115346
2019,Хасково,0,1847,960,887
2019,Хасково,1 - 4,8289,4218,4071
2019,Хасково,5 - 9,11340,5764,5576
2019,Хасково,10 - 14,11255,5755,5500
2019,Хасково,15 - 19,10231,5290,4941
2019,Хасково,20 - 24,8734,4583,4151
2019,Хасково,25 - 29,10903,5797,5106
2019,Хасково,30 - 34,13418,7028,6390
2019,Хасково,35 - 39,15122,8030,7092
2019,Хасково,40 - 44,16761,8706,8055
2019,Хасково,45 - 49,16639,8690,7949
2019,Хасково,50 - 54,15576,7802,7774
2019,Хасково,55 - 59,16284,8037,8247
2019,Хасково,60 - 64,17057,8228,8829
2019,Хасково,65 - 69,16063,7251,8812
2019,Хасково,70 - 74,13583,5733,7850
2019,Хасково,75 - 79,9624,3731,5893
2019,Хасково,80 - 84,6862,2438,4424
2019,Хасково,85 - 89,4286,1484,2802
2019,Хасково,90 - 94,1259,392,867
2019,Хасково,95 - 99,172,52,120
2019,Хасково,100+,12,2,10
2019,Шумен,Общо,172262,83922,88340
2019,Шумен,0,1410,722,688
2019,Шумен,1 - 4,5973,3109,2864
2019,Шумен,5 - 9,8148,4165,3983
2019,Шумен,10 - 14,8398,4351,4047
2019,Шумен,15 - 19,8226,4248,3978
2019,Шумен,20 - 24,7281,3748,3533
2019,Шумен,25 - 29,9648,4978,4670
2019,Шумен,30 - 34,11158,5581,5577
2019,Шумен,35 - 39,11137,5697,5440
2019,Шумен,40 - 44,12846,6602,6244
2019,Шумен,45 - 49,13346,6939,6407
2019,Шумен,50 - 54,12438,6415,6023
2019,Шумен,55 - 59,12276,6233,6043
2019,Шумен,60 - 64,12360,5864,6496
2019,Шумен,65 - 69,12431,5562,6869
2019,Шумен,70 - 74,10780,4469,6311
2019,Шумен,75 - 79,6967,2694,4273
2019,Шумен,80 - 84,4325,1474,2851
2019,Шумен,85 - 89,2359,854,1505
2019,Шумен,90 - 94,661,188,473
2019,Шумен,95 - 99,89,26,63
2019,Шумен,100+,5,3,2
2019,Ямбол,Общо,117335,57408,59927
2019,Ямбол,0,1106,575,531
2019,Ямбол,1 - 4,4542,2292,2250
2019,Ямбол,5 - 9,5999,3069,2930
2019,Ямбол,10 - 14,6118,3096,3022
2019,Ямбол,15 - 19,5521,2871,2650
2019,Ямбол,20 - 24,4413,2346,2067
2019,Ямбол,25 - 29,5516,2952,2564
2019,Ямбол,30 - 34,6695,3508,3187
2019,Ямбол,35 - 39,7132,3853,3279
2019,Ямбол,40 - 44,8085,4200,3885
2019,Ямбол,45 - 49,8085,4159,3926
2019,Ямбол,50 - 54,8000,4043,3957
2019,Ямбол,55 - 59,8800,4346,4454
2019,Ямбол,60 - 64,8690,4213,4477
2019,Ямбол,65 - 69,8915,4153,4762
2019,Ямбол,70 - 74,7702,3251,4451
2019,Ямбол,75 - 79,5247,2061,3186
2019,Ямбол,80 - 84,3921,1411,2510
2019,Ямбол,85 - 89,2178,780,1398
2019,Ямбол,90 - 94,598,204,394
2019,Ямбол,95 - 99,69,24,45
2019,Ямбол,100+,3,1,2
